##name	English Hebrew Paganism
##sourceLang	English
##targetLang	Hebrew
##bgl_defaultCharset	cp1252
##bgl_sourceCharset	cp1252
##bgl_targetCharset	cp1255
##bgl_defaultEncoding	cp1252
##bgl_sourceEncoding	cp1252
##bgl_targetEncoding	cp1255
##sourceCharset	UTF-8
##targetCharset	UTF-8
##utf8Encoding	
##spellingAlternatives	
##caseSensitive	
##bgl_middleUpdated	2005/03/02, 23:59
##author	Carmit Mizrahi
##description	English Hebrew Dictionary for Pagan Religions, Mythology, Wicca, Folklore, Magic and Witchcraft.
##bgl_creationTime	2002/11/12, 08:30
8EAF66FD.bmp	File: 8EAF66FD.bmp
C2EEF3F6.html	File: C2EEF3F6.html
Aakuluujjusi	<B>(ש"פ) </B>אקולוג'וסי. <BR>אלת הפריון ובוראת העולם במיתולוגיה של שבטי האינואיט.
Aatxe	<B>(ש"פ)</B> אטזה. <BR>במיתולוגיה הבאסקית רוח רעה בדמות פר (לעתים גם בדמות אדם) המגיחה מחורה בימות סערה. משמעות שמו: עגל, פר צעיר.
Abaangui	<B>(ש"פ)</B> אבָּנְגואי. <BR>אל במיתולוגיה של שבט גארני (בוליביה, פרגוואי, ברזיל וארגנטינה). סיפורו הוא סיפור בריאת הירח: האל כרת את אפו, האף התעופף השמימה והפך לסהר.
Abaasy	<B>(ש"פ)</B> אבאסי. <BR>שוכני העולם התחתון בעלי שיני הברזל במיתולוגיה של שבט יקוט (צפון מזרח סיביר וצפון מונגוליה). האבאסי מתהלכים תמיד בשביעיות.
Ababilini	<B>(ש"פ)</B> אבביליני. <BR>רוח האש במיתולוגיה של שבט צ'יקסו האינדיאני (מיסיסיפי, קנטאקי, אלבמה, טנסי, אוקלהומה). משמעות השם: "יושב במרומים".
Abadir	<B>(ש"פ)</B> אב אדיר. <BR>כינוי לאל, מלך האלים במיתולוגיה הפניקית.
Abandinus	<B>(ש"פ)</B> אבנדינוס. <BR>אל קלטי רומאי.
Abaris|Hyperborean|The Hyperborean	<B>(ש"פ)</B> אבריס. <BR>כהן אפולו שנמלט מסקיתיה ליוון בגלל מגפה. אפולו נתן לו חץ זהב מכושף שבכוחו היה להפוך את הכהן לרופא ואינו נראה, לאפשר לו לעוף, לרפא מחלות ולהגיד עתידות. על פי האגדה נתן אבריס את החץ הקסום לפיתגורס.
Abarta	<B>(ש"פ)</B> אברטה. <BR>אל אירי קלטי, מן הטואטה דה דנאן. פירוש שמו 'מבצע מעשי הגבורה'.
Abas	<B>(ש"פ)</B> אבאס. במיתולוגיה היוונית כמה דמויות בשם זה: <BR>1. בן היפרמנסטרה מלכת ארגוס.<BR>2. ע"פ אובידיוס, ידיד דיומדס, שאפרודיטה הפכה לברבור.<BR>3. ע"פ אובידיוס, ידיד פרסאוס.<BR>4. ע"פ וירגיליוס, ידיד טרויאני של איניאס.<BR>5. ע"פ וירגיליוס, ידיד אטרוסקי של איניאס.
Abassi	<B>(ש"פ)</B> אבאסי. במיתולוגיה של האֶפִיק (מזרח ניגריה), האל שברא את בני האדם מעפר במצוות אשתו, אך אסר עליהם להתרבות ולעבוד.
Abathur|Abatur	<B>(ש"פ)</B> אבתור. "בעל המאזניים" במיתולוגיה הפרסית. יצור שוכן שאול שתפקידו לשקול את נשמות המתים ולהחליט האם מקומם בגן העדן או בגיהנום. מסמל את "החיים השלישיים".
Abatur	<B>(ש"פ)</B> אבטור, אבתור. אבי דמיורגוס באמונה הגנוסטית.
Abba Amona	<B>(ש"פ)</B> אבא אמונה. הזיווג האלוהי בקבלה.
Abderus	<B>(ש"פ)</B> אבדרוס. במיתולוגיה היוונית, ידיד הרקלס שהופקד לשמור על סוסות דיומדס, אך הן טרפו אותו. על פי האגדה ייסד הרקלס את העיר אבדרה בתרקיה לזכרו.
Abdiel	<B>(ש"פ)</B> אבדיאל. על פי "גן העדן האבוד" לג'ון מילטון, שרף שעמד לצידו של השטן כשניסה להדיח את המלאכים למרד.
Abdrianahoabu	<B>(ש"פ)</B> אבדריאנוהאבו. במיתולוגיה של תושבי מדגסקר, אלה ממשפחת זנקארי. גבירה נעלה היורדת לעולם בעזרת שלשלת כסף.
Abellio	<B>(ש"פ)</B> אבליו. אל עצי התפוחים הגלי. מקורו בעמק גרון בצרפת.
Abeona	<B>(ש"פ)</B> אבאונה. במיתולוגיה הרומאית, האלה השומרת על הילדים העוזבים את הבית. תאומתה אדאונה שומרת על הילדים השבים הביתה.
Abgal|Apkallu	<B>(ש"פ)</B> אבגל. במיתולוגיה השומרית, שבעת אנשי הדגים החכמים שעלו מן המים המתוקים של אפסו והמשרתים את אנקי אל המים והחוכמה.
Abhean	<B>(ש"פ)</B> אבין, אבאין. אל אירי קלטי, נגן הנבל של הטואטה דה דנאן.
Abnoba	<B>(ש"פ)</B> אבנובה. אלת נהר, יערות וציד קלטית רומאית.
Abora	<B>(ש"פ)</B> אבורה. אל השמים במיתולוגיה של תושבי האי פלמה (האיים הקנריים).
Absu|Abzu|Apsu	<B>(ש"פ)</B> אבזו, אפסו. במיתולוגיה המסופוטמית, אל המים המתוקים. בראשית היו רק אפסו המים המתוקים ותהמת המים המלוחים.
Abuk	<B>(ש"פ)</B> אבוק. במיתולוגיה של שבט הדינקה (דרום סודן), האשה הראשונה ואלת הנשים והגנים.
Abundantia	<B>(ש"פ)</B> אבונדנטיה. במיתולוגיה הרומאית, אלת השפע, הפריון והמזל הטוב. היא אלת קרן השפע, השופעת כסף ותבואה.
Abydos	<B>(ש"פ)</B> אבידוס. במיתולוגיה המצרית, עיר קדושה לאוסיריס, שם על פי האגדה קבורה גופתו.
Ac Yanto	<B>(ש"פ)</B> אק ינטו. אל הגברים הלבנים במיתולוגיה של המאיה.
Acadine	<B>(ש"פ)</B> אקדין. במיתולוגיה היוונית, מעיין אגדי בסיציליה
Acamas	<B>(ש"פ)</B> אקָמס. במיתולוגיה היוונית, בנם של תזאוס ופיידרה. היה אחד מן הלוחמים היוונים שהסתתרו בתוך הסוס הטרויאני.
Acan	<B>(ש"פ)</B> אָקַן. אל היין במיתולוגיה של המאיה.
Acanthia	<B>(ש"פ)</B> אקנתיה. במיתולוגיה היוונית, רוח שיח הקוציץ. היא היתה נימפה שאהבה השמש, וכשמתה הפכה לצמח אוהב שמש.
Acanthis	<B>(ש"פ)</B> אקנתיס. בת אוטונוס והיפומניה, אחות אקנתוס. היא בכתה על מות אחיה והאלים הפכוה לחוחית.
Acanthus	<B>(ש"פ)</B> במיתולוגיה היוונית, בנם של אוטונוס והיפומניה. סוסי אביו קרעוהו לגזרים. אחותו ביכתה את מותו והפכה לחוחית.
Acarnan	<B>(ש"פ)</B> אקרנן. במיתולוגיה היוונית בנו של אלקמנון.
Acastus	<B>(ש"פ)</B> אקסטוס. במיתולוגיה היוונית מלך יולקוס, בנו של פליאס ואחד מן הארגונאוטים.
Acat	<B>(ש"פ)</B> אָקַט. אל הקעקועים במיתולוגיה של המאיה.
Acca Larentia	<B>(ש"פ)</B> אקה לרנטיה. במיתולוגיה הרומאית, מאהבת הרקולס ואשת טרוטיוס. תרמה את הון בעלה לעם הרומאי לאחר מותו ולכן חוגגים לכבודה בחגיגת הלרנטליה (23 דצמבר). הלרנטליה היא במקורה חגיגת מתים לאלה לרנטיה. <HR><B>(ש"פ)</B> אקה לרנטיה. במיתולוגיה הרומאית, אשת הרועה פאוסטולוס, שגידלה את התאומים רומוס ורמולוס מייסדי העיר.
Accolon	<B>(ש"פ)</B> אקולון. במיתולוגיה הארתורית, אחד ממאהביה של מורגן לה פיי. מורגן גנבה את אקסקליבר, חרבו הקסומה של המלך ארתור והעניקה אותה לאקולון במתנה. ארתור יצא לקרב עם אקולון והשיב את החרב.
Acestes|Egestes	<B>(ש"פ)</B> אקסטס, אגסטס. במיתולוגיה היוונית, גיבור טרויאני שסייע לאיניאס בסיציליה.
Acgaeus	<B>(ש"פ)</B> אקגיאוס. במיתולוגיה היוונית נכדו של המלך ארכתאוס.
Achaemenides	<B>(ש"פ)</B> אכימנידס. במיתולוגיה היוונית, אחד ממלווי אודיסאוס שנותרו עם הקיקלופים בסיציליה. אכימנידס עזב את סיציליה עם איניאס שהגיע לאי מאוחר יותר.
Achall	<B>(ש"פ)</B> אכאל. במיתולוגיה האירית קלטית, נערה שמתה מצער לאחר שנהרג אחיה בקרב.
Achates	<B>(ש"פ)</B> אכטיס. במיתולוגיה היוונית, ידיד של איניאס.
Achelois	<B>(ש"פ)</B> אכלואיס. במיתולוגיה היוונית, אלת ירח ושיכוך כאבים. האורקל הדודוני הורה להקריב לה קרבנות.
Achelous	<B>(ש"פ)</B> אכלואוס. אל נהר יווני. בנם הבכור של אוקיינוס ותטיס, נלחם עם הרקולס על ידה של דיאנירה והובס. דמותו גבר מזוקן בעל גוף שור או איש זקן בעל קרניים.
Acheron	<B>(ש"פ)</B> אכרון. נהר ביוון. על פי האמונה היוונית, הוא זורם עד ממלכת האדס בשאול, מפני שבחלקים מסוימים הוא זורם בערוצים צרים, עמוקים וחשוכים. <BR>
Acherusia	<B>(ש"פ)</B> אכרוסיה. במיתולוגיה היוונית, שם מערה אליה גרר הרקלס את קרברוס כלב השאול.
Achilles	<B>(ש"פ)</B> אכילס. גיבור יווני שכל גופו פרט לעקבו היה מחוסן ממוות. נהרג בידי חץ ששילח פריס בעקבו במהלך מלחמת טרויה. מכאן הביטוי 'עקב אכילס'.
Achtan	<B>(ש"פ)</B> אכטן. במיתולוגיה האירית קלטית, גיבורה ואמו של המלך קורמק.
Achtland	<B>(ש"פ)</B> אכטלנד. במיתולוגיה הקלטית, מלכה שלא שבעה תשוקתה מגברים, ולכן לקחה לה ענק לבעל.
Acidalia	<B>(ש"פ)</B> אסידליה. כינוי לאלה היוונית אפרודיטה, על שם מעיין בו נהגה לטבול.
Acis	<B>(ש"פ)</B> אסיס. במיתולוגיה היוונית, רועה צעיר, בנו של דיוניסוס. הקיקלופ פוליפמוס, שנאבק עמו על לבה של גלטאה, השליך עליו אבן והרגו.
Aclla	<B>(ש"פ)</B> אקלה. בתולות השמש הקדושה בתרבות האינקה. האקלה היו כוהנות שהקריבו עצמן בעיתות מצוקה קשות כדי להפיס את זעם האלים.
Acmon	<B>(ש"פ)</B> אקמון. במיתולוגיה היוונית, ידיד של איניאס.
Acoetes	<B>(ש"פ)</B> אקואטס. במיתולוגיה היוונית, רב חובל של אונייה שעל סיפונה הפליג דיוניסוס, מחופש לעלם יפה תואר. הוא הציל את האל מידי הספנים שרצו לחטוף אותו והפך לכהן בנקסוס. דיוניסוס הפך את הספנים לדולפינים.
Acolmitzli	<B>(ש"פ)</B> אייקולמיצלי. אל שאול אצטקי.
Acolnahuacatl	<B>(ש"פ)</B> אייקולנוואקטל. אל שאול אצטקי.
Acoran	<B>(ש"פ)</B> אקורן. אל עליון באי גרן קנריה (האיים הקנריים).
Acrisius|Akrisios	<B>(ש"פ)</B> אקריזיוס. במיתולוגיה היוונית, מלך שכלא את בתו דנאי במגדל ארד לאחר שניבאו לו שבנה יהרוג אותו. זאוס מלך האלים התאהב בדנאי וחדר לכלאה בצורת גשם של זהב. מאיחודם נולד פרסאוס, שלימים הרג את אקריזיוס בתאונה.
Acteon|Actaeon	<B>(ש"פ)</B> אקטאון. צייד יווני שהאלה ארטמיס הפכה לאייל לאחר שראה אותה מתרחצת באגם.
Actor	<B>(ש"פ)</B> אקטור. במיתולוגיה היוונית, מלך אופוס בלוקריס, אבי מנואטיוס ואסטיוכה.
Acuecucyoticihuati	<B>(ש"פ)</B> אֵייקְוֵוקוֹקְיוֹיטִיקִיוָוטי. אלת האוקיינוס, הנהרות, הנחלים, המים הזורמים והלידה במיתולוגיה האצטקית.
Adaheli	<B>(ש"פ)</B> אדהלי. אל השמש בסורינם.
Adamanthea	<B>(ש"פ)</B> אדמנתיאה.
Adamastor	<B>(ש"פ)</B> אדמסטור. רוח כף התקווה הטובה או כף הסערות. היא מתוארת בכתבי לואיס דה קאמוס (המאה ה-16). היא הופיעה בפני וסקו דה גאמה וסיפרה לו שמסעו להודו יסתיים באסון.
Adaox	<B>(ש"פ)</B> אדאוקס. רוחות בעלי חיים ההופכות לבני אדם במיתוס הבריאה של שבט הצימישיאן האינדיאני.
Adapa	<B>(ש"פ)</B> אדפה. במיתולוגיה השומרית, כהן גדול לאל המים והחוכמה אנקי בעיר ארידו. אדפה שבר את כנף רוח הדרום ונענש על ידי אנו מלך השמים ומושל הרוחות. הוא קיווה לקבל חיי נצח, אך בהוראת אנקי נמנע מלאכול ולשתות בשמים ולכן נותר בן תמותה.
Adar|Adarmelech|Adrammelech	<B>(ש"פ)</B> אדר, אדרמלך. אל ספרווים באשור, לו העבירו ילדים באש כקרבן. מלכים ב', י"ז, ל"א: "וְהָעַוִּים עָשׂוּ נִבְחַז, וְאֶת-תַּרְתָּק; וְהַסְפַרְוִים, שֹׂרְפִים אֶת-בְּנֵיהֶם בָּאֵשׁ, לְאַדְרַמֶּלֶךְ וַעֲנַמֶּלֶךְ, אֱלֹהֵי סְפַרְוָיִם". <BR>
Adaro	<B>(ש"פ)</B> אדרו. על פי אמונת תושבי האי מאלה, החלק הרע שבנשמת האדם, ההופך לרוח רפאים לאחר המוות.<HR><B>(ש"פ)</B> אדרו. באיי סולומון, רוח רעה בדמות איש בעל זנב דג, קשקשים מאחורי האזניים, סנפיר כריש בגב וקוצי דג חרב בראש. האדרו גולש על גבי הקשת בענן והורג אנשים על ידי השלכת דגים רעילים.<BR>
Adekagagwaa	<B>(ש"פ)</B> אדֵקָגָגְוָוה. רוח הקיץ במיתולוגיה של השבט ארקווי האינדיאני.
Adeona	<B>(ש"פ)</B> אדאונה. במיתולוגיה הרומאית, האלה השומרת על הילדים השבים הביתה. תאומתה אבאונה שומרת על הילדים העוזבים את הבית.<BR>
Aditinggi	<B>(ש"פ)</B> אדיטינגי. אל הר הגעש גונונג אאו באינדונזיה.
Adjassou-Linguetor|Adha Bosu|Adja|Adjassou Linguetor	<B>(ש"פ)</B> אדְיָסו לינגטור. במיתולוגיה הקריבית לואה (אלוהות טבע) של מי מעיינות. עיניה בולטות ומזגה זועף. נקראת גם אדיה או אדה בוסו.
Adjinakou	<B>(ש"פ)</B> אדיינקו. במיתולוגיה הקריבית, לואה (אלוהות טבע) של הפילים בהאיטי.
Adlet	<B>(ש"פ)</B> אדלט. במיתולוגיה האסקימוסית, עשר מפלצות מוצצות דם. חמש מהן נולדו כתוצאה מזיווג של אשה עם כלב אדום.
Adlivun	<B>(ש"פ)</B> אדליבון. במיתולוגיה האקסימוסית, "אלו שמתחתנו", שוכני העולם התחתון הימי, שם מטוהרות רוחות המתים לפני שהן עוברות לארץ הירח.
Admete|Admeta	<B>(ש"פ)</B> אדמטה. במיתולוגיה היוונית, בת יוריסתיאוס. הרקלס גנב למענה את חגורת היפוליטה.
Admetus	<B>(ש"פ)</B> אדמטוס. במיתולוגיה היוונית, מלך פריי בתסליה. האל אפולו שגורש מן האולימפוס היה רועה שלו במשך תשע שנים. בתמורה ליחס הטוב שקיבל מאדמטוס במהלך השנים, העניק לו האל חסד: בבוא יומו יוכל לבחור מי ימות במקומו. הוא גם סייע לו לזכות בידה של אלכסטיס. בשעת מותו התנדבה אשתו למות במקומו, אך בהתערבות הרקלס ניצלו חייה.
Adon	<B>(ש"פ)</B> אדון. אל הצמיחה הפניקי. תיאור אהבתו לאלה עשתרת ומותו בידי חזיר בר, כמו גם הפולחנים לכבודו מתוארים אצל <A href='http://10brinkster.com/loreley/dedeasyria.htm'>לוקיאנוס - האלה הסורית</A>.
Adonis	<B>(ש"פ)</B> אדוניס. דמותו היוונית של האל הפניקי אדון. אדוניס הוא אל צמיחה צעיר ויפהפה ואהובה של אפרודיטה. הוא נהרג בידי חזיר בר ולאחר מותו הפכה אותו אפרודיטה לכלנית.
Adrasteia|Adrastea	<B>(ש"פ)</B> אדרסתיאה. "היא שממנה לא יוכל להימלט איש". במיתולוגיה היוונית, כינוי לאלה הגדולה ריאה קיבלי, המענישה את בני האדם על חטאיהם.
Adrastus|Adrastos	<B>(ש"פ)</B> אדרסטוס. "עומד על שלו". במיתולוגיה היוונית, מלך ארגוס, שהשיא את בנותיו לטידאוס ולפוליניקס. שני חתניו גורשו מן העיר והוא יצא במסע "השבעה נגד תבי" כדי להשיבם. הוא מת מצער על מות בנו אייגלסוס. בחלק מן הערים היווניות נחשב חצי אל. <HR><B>(ש"פ)</B> אדרסטוס. במיתולוגיה היוונית, בנו של גורדיאס מלך פריגיה, שהרג בטעות את אחיו. הוא נמלט ללידיה ושם הרג בטעות את בנו של קרואזוס, לכן התאבד.
Adriamahilala	<B>(ש"פ)</B> אדריאמהיללה. במיתולוגיה של מדגסקר, האשה הראשונה, אשתו של אדריאמבהומננה. מדי חודש היא נשלחת לירח ומתה, אך נולדת מחדש בחודש הבא.
Adriambahomanana	<B>(ש"פ)</B> אדריאמבהומננה. במיתולוגיה של מדגסקר, האיש הראשון, בעלה של אדריאמהיללה. לאחר שהוליד הזוג הראשון ילדים רבים ונולדו לו גם נכדים, שאל אותם אלוהים כיצד יבחרו למות. אדריאמבהומננה בחר למות כמו צמח הבננה, שמותיר אחריו נצר חי. אדריאמהיללה בחרה למות כמו הירח ולהיוולד מחדש בכל חודש.
Adroa	<B>(ש"פ)</B> אדרואה. האל של שבט לוגברה השוכן בגבול זאיר ואוגנדה. הוא בורא השמים והארץ ומתגלה לפני האנשים העומדים למות. הוא גבוה, לבן ויש לו חצי גוף: עין אחת, אוזן אחת, זרוע אחת ורגל אחת. ילדיו, אדרואנזי, הם רוחות טבע ושוכנים בסלעים, בעצים ובנחלים.
Adroanzi	<B>(ש"פ)</B> אדרואנזי. ילדיו של אדרואה, האל של שבט לוגברה האפריקאי. האדרואנזי רוחות טבע השוכנים בנחלים, בעצים ובסלעים. הם נוהגים לעקוב אחרי בני אדם בלילות. על פי האמונה של בני השבט, אם האדם סובב על עקביו כדי להביט בהם, הוא ימות.
Adsullata	<B>(ש"פ)</B> אדסולטה. אלת נהר קלטית.
Adya Houn'to	<B>(ש"פ)</B> אדיה הוונטו. במיתולוגיה הקריבית, לואה (אלוהות טבע) של התופים בתהלוכה דתית הנקראת אדיה.
Aea	<B>(ש"פ)</B> אאוס. במיתולוגיה היוונית, האי שבו חיה המכשפה קירקה, שהיתה כהנת לאלה הקטה.
Aeacus	<B>(ש"פ) </B>איאקוס. בן זאוס, סב אכילס ושופט בשאול תחתיות.
Aedon	<B>(ש"פ)</B> אאדון. במיתולוגיה היוונית, אשת זתוס. היא הרגה את בתה איטילוס בשגגה וזאוס הפך אותה לזמיר השר בשירת קינה נצחית על הבת המתה.<HR><B>(ש"פ)</B> אאדון. במיתולוגיה היוונית, מלכת תבי, שתכננה להרוג את בנה של ניובה, אך הרגה את בנה שלה בשגגה. היא ניסתה להתאבד אך האלים הפכוה לזמיר השר כל הלילה את שירת השכול.
Aeetes|Aietes	<B>(ש"פ)</B> אאיטס. במיתולוגיה היוונית, בן הליוס אל השמש ומלך קלוכיס. בתו המכשפה מדיאה סייעה ליאסון ולארגונאוטים לגנוב את גיזת הזהב.
Aega	<B>(ש"פ)</B> אייגה. במיתולוגיה היוונית, נימפה שטיפלה בזאוס התינוק כשהיה על ריאה אמו להחביאו מכרונוס אביו שרצה להרגו. היא הסתירה את זאוס בעריסה שתלתה על עץ.
Aegea|Aga	<B>(ש"פ)</B> אייגה. במיתולוגיה יוונית, בת השמש אחותן של המכשפה קירקה ושל אשת המלך מינוס פסיפיי. גיאה החביאה אותה במערה בעת מלחמת הטיטנים באלים האולימפיים.
Aegealeus|Aegialeus	<B>(ש"פ)</B> אייגיאלוס. במיתולוגיה היוונית, בנו של אדרסטוס. יצא לנקום את נקמת אביו שמת במסע "השבעה נגד תבי". הוא נהרג בקרב.
Aegeon	<B>(ש"פ)</B> אייגאון. "תיש". כינוי הומרי לבריארוס, אחד מן ההקטונכירס. אייגאון הוא בנו של פוסידון ואל הים האגאי.
Aegeus	<B>(ש"פ)</B> איגיאוס. מלך אתונה, בן המלך פנדיון ואבי הגיבור תזאוס.
Aegiale	<B>(ש"פ)</B> אייגיאל. בת אדרסטוס ואמפטריאה. היא לא היתה נאמנה לבעלה שגורש מן העיר.
Aegimius	<B>(ש"פ)</B> אייגימיוס. במיתולוגיה היוונית, אבי הדוריים. הרקלס סייע לו במלחמתו עם הלפיתים. כדי להביע את הכרת תודתו, אימץ את בנו של הרקלס הילוס, שעל שמו נקרא אחד משלושת השבטים הדוריים.
Aegina	<B>(ש"פ)</B> אייגינה. במיתולוגיה היוונית, בת אל הנהר אזופוס. זאוס חטף אותה לאי אתיקה והיא ילדה לו את אייקוס, מלך האי.
Aegir	<B>(ש"פ)</B> אייגיר. אל הים במיתולוגיה הסקנדינבית. למרות שהוא מפורסם בנדיבותו כלפי האלים, חששו ממנו בני האדם. הוא משבר ספינות ולוקח את משאותיהן ומלחיהן לארמונו שבתחתית הים. יורדי הים הקריבו לו קרבנות כדי להפיסו ולהימלט מזעמו. אשתו, אלת הים רן, ילדה לו את תשע בנות הגלים.
Aegis	<B>(ש"פ)</B> אאגיס. שריון מגן קסום שעונדים האלים היווניים זאוס, הרה ואתנה.
Aegisthus	<B>(ש"פ) </B>איגיסתוס. במיתולוגיה היוונית דודן אגממנון. הוא אנס את אשת אגמננון קליטמנסטרה ונהרג בידי אורסטס בנה בנקמה.
Aegyptus	<B>(ש"פ)</B> איגיפטוס. מלך מצרים, בן בלוס. חמישים בניו נישאו לחמישים הדנאידות, בנות אחיו התאום דנאוס.
Aello	<B>(ש"פ)</B> איילו. אחת משלוש ההרפיות, "השודדות", מפלצות מכונפות בעלות פני אשה זקנה וטפרים חדים ומעוקלים. ההרפיות הן שליחות האלים להענשת בני אדם. הן מענות אותם וגוררות אותם לשאול. אבמיתוסים מוקדמים תוארה איילו כעלמה יפהפייה. היא "רוח מהירה".
Aeneads	<B>(ש"פ)</B> איניאדים. במיתולוגיה היוונית, בני לוויתו של איניאס שהצטרפו אליו במסעותיו.
Aeneas	<B>(ש"פ)</B> איניאס. במיתולוגיה היוונית, לוחם במלחמת טרויה. בן אפרודיטה ואנכיסס ובן דודו של הקטור.
Aengus|Anghus|Angus|Angus Og|Angus the Young|Aonghus	<B>(ש"פ)</B> אינגוס, אנגוס. אל האהבה והשירה האירי.
Aeolus	<B>(ש"פ)</B> איאולוס. אל הרוח היווני ופטרון ארבע רוחות השמים.
Aeope|Aerope	<B>(ש"פ)</B> איירופ. במיתולוגיה היוונית, אשת אטראוס שבגדה בו עם אחיו תיאסטס.
Aequitas	<B>(ש"פ)</B> איקיטס. במיתולוגיה הרומאית, אל המסחר ההוגן.
Aera Cura|Aericura	<B>(ש"פ)</B> אירה קורה. במיתולוגיה הרומאית, אלת ממלכות השאול. בתקופת הכיבוש הרומאי בבריטניה נעבדה גם על ידי הקלטים ונקראה אייריקורה.
Aericura	<B>(ש"פ)</B> אריקורה. אלת שאול קלטית רומאית.
Aes Sidhe	<B>(ש"פ)</B> אייס שי, אנשי הגבעות. מונח גלי המתאר את האלים הקלטים הקדומים השוכנים בגבעות.
Aesacus	<B>(ש"פ)</B> אייסקוס. במיתולוגיה היוונית, בנם של פריאמוס ואלכסירוהה. הוא התאהב בנימפה הספריה, בתו של אל הנהר הטרויאני קברן. הספריה ביקשה להימלט מחיזוריו ומתה מנשיכת אפעה. ביגונו ניסה אייסקוס לטבע את עצמו, אך תטיס, אלת האוקיינוס הטובה, הפכה אותו לציפור.
Aesculapius|Asclepius	<B>(ש"פ) </B>אסקלפיוס. גיבור יווני שהפך לאל הרפואה. מאוחר יותר אימצו אותו הרומאים. בן אפולו וכורוניס, ואבי אכסו, יאסו, פנקיי, אגליי והיגייה. סמלו הוא המטה שמתפתל עליו נחש, סמל הרפואה. בעל החיים המקודש לאסקלפיוס הוא התרנגול.
Aesir	<B>(ש"פ)</B> אייסיר. אחת משתי קבוצות האלים במיתולוגיה הסקנדינבית, המושלת בחייהם של בני האדם. הקבוצה השניה היא וניר, אלים המושלים בתנועות הטבע. האייסיר שוכנים באסגרד, היכלו של האל העליון אודין.
Aesma Daeva|Aeshma|Aesma	<B>(ש"פ)</B> אשמא דבא. "זעם" או "חמה". במיתולוגיה הפרסית שד הכעס, התאווה, הזעם והנקמה. יחד עם שד המוות אסטו וידטו הוא רודף אחר נשמות המתים במסען לשמים. אשמדאי הוא גלגול יהודי של אשמא דבא.
Aeson	<B>(ש"פ)</B> אייסון. במיתולוגיה היוונית, מלך יולקוס, שהודח ממלוכתו על ידי אחיו פליאס. בנו יאסון יצא למסע על סיפון הארגוס כדי למצוא את גיזת הזהב ולהשיב לעצמו את המלוכה.
Aeternitas	<B>(ש"פ)</B> אטרניטס. במיתולוגיה הרומאית, נחש שזנבו בפיו או עוף חול הקם לתחייה מאפרו. אטרניטס הוא סמל לחיי נצח.<BR>
Aethalides	<B>(ש"פ)</B> איתלידס. במיתולוגיה היוונית, בנו של האל הרמס. הוא סייע ליאסון והארגונאוטים במסעם.
Aether	<B>(ש"פ)</B> אתר. במיתולוגיה היוונית, בנם של ארבוס וניקס, החושך והלילה, ואחיה של המרה, אלת היום. אתר הוא סמל לאויר העליון שבו חיים האלים או לרוח האלוהית המעניקה חיים והוא נחשב אחד מכוחות היקום.
Aethon	<B>(ש"פ)</B> איתון. על פי אובידיוס, סוסו של אל השמש היווני הליוס. <HR><B>(ש"פ)</B> איתון. על פי וירגיליוס, סוסו של הטיטן היווני פלס.<HR><B>(ש"פ)</B> איתון. במיתולוגיה היוונית, ההתגלמות האלוהית של הרעב והבצורת.
Aethra	<B>(ש"פ)</B> איתרה. במיתולוגיה היוונית, אשתו של אגיאוס ואם הגיבור תזאוס.
Aetna	<B>(ש"פ)</B> איתנה. במיתולוגיה היוונית, אלת הר הגעש הסיצילי אתנה, בתם של אורנוס וגיאה.
Aetolus	<B>(ש"פ)</B> איטולוס. במיתולוגיה היוונית, בנו של אנדימיון. אנדימיון היה רועה שאלת הירח סלין התאהבה בו.
Aeval|Aibell|Aoibhell	<B>(ש"פ)</B> אייבל. מלכת הפיות של מונסטר במיתולוגיה הקלטית. בחצות הלילה היא שופטת גברים שאינם מספקים את נשותיהם.
Afa	<B>(ש"פ)</B> אפה. אל הסערות והסופות בסמואה.
Africus	<B>(ש"פ) </B>אפריקוס. במיתולוגיה הרומאית, הרוח הדרום מערבית.
Agamemnon	<B>(ש"פ) </B>מלך יווני שנרצח בידי אשתו קליטמנסטרה ומאהבה כשחזר ממלחמת טרויה.
Aganippe	<B>(ש"פ)</B> אגניפה. "סוסה ההורגת ברחמים". במיתולוגיה היוונית, נימפה בת אל הנהר טרנסוס. היא שוכנת במעיין הנקרא על שמה למרגלות הר הליקון והקדוש גם למוזות.
Aganippides	<B>(ש"פ)</B> אגניפידות. כינוי למוזות במיתולוגיה היוונית. הן נקראות כך מפני שהמעיין המקודש להן למרגלות הר הליקון קדוש גם לנימפה אגניפי.
Agas	<B>(ש"פ)</B> אגס. "עין רעה". במיתולוגיה הפרסית, שדת המחלות שנגרמות לאדם כתוצאה מעין רעה.
Agasaya	<B>(ש"פ)</B> אגסאייה. אלת מלחמה שמית קדומה. בתקופות מאוחרות התמזגה דמותה עם אישתר, אלת התשוקה האלימה.
Agassou	<B>(ש"פ)</B> אגסו. במיתולוגיה הקריבית, שומר הלואה (אלוהויות טבע).
Agave	<B>(ש"פ)</B> אגבי. "מאירה". בת קדמוס ואמו של פנתאוס. דיוניסוס היכה אותה בטירוף והיא הרגה את בנה.
Agdistis|Agdos	<B>(ש"פ)</B> אגדיסטיס. שמו של הסלע באסיה הקטנה שאליו הפכה את עצמה אלת הפריון קיבלי. זאוס התעלס עם הסלע ומן האיחוד נולד אנדרוגינוס, שגם כן נקרא אגדיסטיס.
Age	<B>(ש"פ)</B> אגֵה. אל הערבות הבלתי מיושבות וחיות הפרא באפריקה.
Agelasta	<B>(ש"פ)</B> אגלסטה. "נטול שמחה". במיתולוגיה היוונית, שם הסלע עליו נחה האלה דמטר במהלך חיפושיה אחר בתה פרספונה.
Agelaus	<B>(ש"פ)</B> אגלאוס. במיתולוגיה היוונית, מחזר של פנלופה, אשת אודיסאוס.
Agemem	<B>(ש"פ)</B> אגמם. אלת הבריאה הטינגויאנית בפיליפינים. היא ובעלה טדקלן בראו את השמש, הירח, הכוכבים והארץ.
Agenor	<B>(ש"פ)</B> אגנור. במיתולוגיה היוונית בנו של פוסידון אל הים ומלך טירוס. אביהם של אירופה וקדמוס.
Agis	<B>(ש"פ)</B> אגיס. במיתולוגיה היוונית בנו של יוריסתנס.
Aglaea|Aglaia	<B>(ש"פ)</B> אגליאה. "בוהק". במיתולוגיה היוונית, הצעירה מבין שלוש בנות החן. לעתים מופיעה כאשתו של הפייסטוס (אשתו של הפייסטוס היא בד"כ אפרודיטה, אלת האהבה).
Aglaulus|Aglaurus	<B>(ש"פ)</B> אגלאולוס (או אגלאורוס). במיתולוגיה היוונית, בת קקרופס, שהיה חצי אדם חצי דרקון. יש שלוש גרסאות לסיפורה. <BR>על פי גרסה אחת, היא השליכה עצמה מן האקרופוליס לאחר שניבא אורקל שמעשה כזה יסיר את המצור שהוטל על העיר אתונה. לאגלאולוס היה מקדש באתונה בו נשבעו אתונאים צעירים להגן על מולדתם.<BR>על פי הגרסה השניה הפקידה האלה אתנה בידי אגלאולוס ושתי אחיותיה הרסי ופנדרוסוס תיבה וציוותה עליהן שלא לפתוח אותה. הרסי פתחה את התיבה והאחיות מצאו בתוכה את הגיבור אריכתוניוס. אגלאולוס הוכתה בטירוף והשליכה עצמה מן האקרופוליס.<BR>על פי הגירסה השלישית היא קינאה באהבת האל הרמס לאחותה הרסי. היא עמדה בדרכו כשרצה לראות את הרסי ואמרה שלא תזוז לעולם. הרמס העניש אותה על פי מילותיה והפך אותה לסלע.
Aglibol	<B>(ש"פ)</B> עגל בעל. במיתולוגיה הפלמירית, אל הירח. הוא חלק מן השילוש הקדוש עם בעל וירח בעל. הוא נושא את גלגל הירח על מצחו או על כתפו.
Agloolik	<B>(ש"פ)</B> אגלוליק. במיתולוגיה האסקימוסית, רוח השוכנת מתחת לקרח ומסייעת ללוכדי הדגים ולציידים.
Agned	<B>(ש"פ)</B> אגנד. במיתולוגיה הארתורית, הר שבו ניצח המלך ארתור את הסקסונים, ישנן כמה השערות לגבי מיקומו המדויק, ביניהן קסלרוק באדינבורו, הר דולורוס והמבצר הרומאי ברוצ'סטר, נורת'מברלנד.
Agnus Castus	<B>(ש"פ)</B> אגנוס קסטוס. בדת ההלנית, סוג עץ מקודש, המסוגל לשמור על צניעותן של נשים.
Agonalia	<B>(ש"פ)</B> אגונליה. ברומא העתיקה, שמן של ארבע חגיגות דתיות שבהן הוקרב קרבן ליופיטר. האגונליה הראשונה נערכה ב-9 לינואר לכבודו של יאנוס, האל בעל שתי הפנים. האגונליה השניה נערכה ב-17 למרץ במהלך החגיגות השנתיות לאל המלחמה מרס, האגונליה השלישית נערכה ב-21 למאי במסגרת חגיגת ויוביס, אל הרפואה הזקן והאחרונה ב-11 לדצמבר לכבוד סול אינדיגנס, אל השמש.
Agravain	<B>(ש"פ)</B> אגרויין. אביר במיתולוגיה הארתורי. הוא היה בנם של לוט ושל מורגוז, אחיו של גאוויין. הוא חשף את דבר אהבתה של אשת ארתור המלכה גווינביר לאביר לנסלוט. לנסלוט הרגו.
Agrestes	<B>(ש"פ)</B> אגרסטס. במיתולוגיה הארתורית, מלך קמלוט לפני ארתור. הוא רדף את יוספוס, בנו של יוסף מארמתיאה, שומר הגראל הקדוש ונענש בטירוף שהובילו למוות.
Agrius	<B>(ש"פ)</B> אגריוס. בנו של פרתאון מלך קלדוניה. בניו הדיחו את אחיו (דודם) אואנאוס מכס המלוכה והמליכו במקומו את אביהם. לאחר זמן ויתר אגריוס על כסאו והשיב אותו לאחיו.
Agrona	<B>(ש"פ)</B> אגרונה. אלת הסכסוכים והטבח הקלטית ואלת הנהר אירון בווילס, שנקרא על שמה.
Agrotora	<B>(ש"פ)</B> אגרוטורה. במיתולוגיה היוונית, כינויה של ארטמיס כציידת והאלה הפטרונית של הציידים.
Agta	<B>(ש"פ)</B> אגטה. במיתולוגיה הפיליפינית, יצורי דמוי אדם עירום גבוה ושחור המתגורר בעצים גדולים ונוהג לעשן סיגרים. האגטה מסייע לדייגים, אך יגנוב מבני האדם בגדים ועצים להסקה אם יפגעו בו.
Aguara	<B>(ש"פ)</B> אגוארה. במיתולוגיה של שבט טונפה האינדיאני, אל השועלים. הוא העניק לבני האדם את עץ החרוב.
Agwe|Agwé|Loa Agwe	<B>(ש"פ)</B> אגווה. אל הדגים וצמחי המים במיתולוגיה ההאיטית, פטרון הדייגים והמלחים. בפולחן לכבודו משלחים המאמינים תשורות ומנחות על פני הים.<HR><B>(ש"פ)</B> אגווה. אלת האוקיינוס הטובה במיתולוגיה האפריקנית. נקראת גם לואה אגווה. לואה הוא שם כללי לאלוהות טבע, המשפיעה על חיי בני האדם.
Ah Bolom Tzacab|Ah Bolon Dzácab	<B>(ש"פ)</B> אה בַּלוּם צָקָבּ. "האל בעל אף העלה". נקרא גם "האל ק". במיתולוגיה של המאיה, אל הגשמים, הרעמים והחקלאות. באפו תחוב עלה ומכאן שמו.
Ah Cancum	<B>(ש"פ)</B> אה קנקוָום. אל הצייד במיתולוגיה של המאיה.
Ah Chun Caan	<B>(ש"פ)</B> אה צ'וָון קן. במיתולוגיה של המאיה, האל הפטרון של העיר מרידה.
Ah Chuy Kak	<B>(ש"פ)</B> אה צ'וי קק. אל המלחמה והאש המאכלת במיתולוגיה של המאיה.
Ah Ciliz	<B>(ש"פ)</B> אה סֶלֶס. אל ליקויי החמה במיתולוגיה של המאיה.
Ah Cun Can	(ש"פ) אה קון קן. אל המלחמה במיתולוגיה של המאיה. ביכולתו להקסים ולכשף נחשים.
Ah Cuxtal	<B>(ש"פ)</B> אה קושטל. אל הלידה במיתולוגיה של המאיה.
Ah Hulneb	<B>(ש"פ)</B> אה וָולְנֶבּ . אל המלחמה במיתולוגיה של המאיה.
Ah Kin|Ah Kinchil|Ahau Kin|Ahau-Kin	<B>(ש"פ)</B> אה קֵן. "השמשי". אל השמש במיתולוגיה של המאיה. הוא מושל גם בצדדיה הטובים של השמש וגם בצדדיה ההרסניים, כגון בצורת ומחלה. בשעות הלילה הוא הופך ליגואר, אל עולם תחתון, ומגיע למזרח מן המערב דרך השאול. נקרא גם אה קנצ'יל או אאו קן.<BR>
Ah Kumix Uinicob	<B>(ש"פ)</B> אה קוָומיש ווינֵקוב. במיתולוגיה של המאיה, משרת של אלי המים.
Ah Mun	<B>(ש"פ)</B> אה מן. אל התירס במיתולוגיה של המאיה.
Ah Muzencab	<B>(ש"פ)</B> אה מַסֶנְקָבּ. אל הדבורים במיתולוגיה של המאיה.
Ah Patnar Uinicob	<B>(ש"פ)</B> אה פָּטְנָר וָואֶקוֹב. משרת של אלי המים במיתולוגיה של המאיה.
Ah Peku	<B>(ש"פ)</B> אה פֶּקְוָוה. אל הרעם במיתולוגיה של המאיה.
Ah Puch|Ahpuch|Huanhau|Hunhau	<B>(ש"ע)</B> אה פְּוָוש. אל המוות במיתולוגיה של המוות. נקרא גם וָונְוָוה או "האל א". ממלכתו היא מיטנל, ארץ המתים, התחום הנמוך ביותר והנורא מבין תשעת מדורי השאול. לאה פווש ראש ינשוף וגוף אדם. עד היום מאמינים במקסיקו ובמרכז אמריקה שצווחות הינשוף מבשרות מוות. אחרים מתארים את האל כשלד או כגופה נפוחה מקושטת בפעמונים.
Ah Tabai	<B>(ש"פ)</B> אה טָבֶּה. אל צייד במיתולוגיה של המאיה.
Ah Toltecat	<B>(ש"פ)</B> אה טולטקט. אל הטולטק בדרום אמריקה.
Ah Uincir Dzacab	<B>(ש"פ)</B> אה וָונְסיר דְסָקבּ. אל הרפואה במיתולוגיה של המאיה.
Ah Uuc Ticab	<B>(ש"פ)</B> אה וָואוָוק טֵקָבּ. אל שאול במיתולוגיה של המאיה.
Aha Njoku	<B>(ש"פ)</B> אה ניוקו. אלת הפריון, הנשים והבטטות שלעם האִיבּוֹ בניגריה. הבטטות הן המזון העיקרי של בניגריה ומסורתית מגדלות אותן נשים, לכן הן קשורות לאדמה ולפריון.
Ahau Chamahez	<B>(ש"פ)</B> אָאוּ צָ'מָאֶז. אחד מצמד אלי רפואה במיתולוגיה של המאיה.
Ahkiyyini	<B>(ש"פ)</B> אקייני. במיתולוגיה האסקימוסית, אקייני היה איש שאהב לרקוד. רוחו, בצורת שלד, שבה לעיתים קרובות לעולם החיים כדי לרקד. אקייני מתופף בזרוע השלד שלו על כתפו בעוז כזה, שהאדמה רועדת וספינות בנהר מתהפכות.
Ahmakiq	<B>(ש"פ)</B> אמקֵק. אל החקלאות במיתולוגיה של המאיה. תפקידו לכלוא את הרוחות המאיימות להשמיד את היבול.
Ahoeitu	<B>(ש"פ)</B> אאויטו. בנו של האל איטומנטופה שירד מן השמים על גבי עץ גדול והזדווג עם צאצאית התולעת אילהבה. כשגדל אאויטו, הוא טיפס על העץ כדי לפגוש את אביו. ילדיו האחרים של איטומנטופה, בני השמים, קינאו באחיהם החורג, קרעו אותו לגזרים, בישלוהו ואכלוהו. אביהם הכועס הורה להם להקיא את נתחי גופו של בנו והשיב אותם לחיים בעזרת צמחים מכושפים. הנער הושב לארץ וקיבל את מלכות טונגה.
Aholi	<B>(ש"פ)</B> אהולי. קצ'ינה של שבט פיקייה במיתולוגיה של ההופי. קצ'ינה הם ראשי שבטים שבתוכם שוכנת רוח אלוהית. לאהולי היתה גלימה קסומה: גלימת האביב, הפריון והשמש הזורחת. דמותו של אל הנביטה מואינגווה היתה רקומה עליה. אהולי היה ידידו הטוב של הקצ'ינה אאוטוטו והסכים שישספו את גרונו, כדי שאאוטוטו יחיה. לסוף הימים נפגשו אהולי ואאוטוטו, סמל לידידות נצח, בכפר אורייבי.
Ahriman	<B>(ש"פ)</B> אחרימן. במיתולוגיה הפרסית כינוי לאנגרה מיניו, אל האופל, מתנגד הטוב.
Ahsonnutli	<B>(ש"פ)</B> אסונוטלי. במיתולוגיה של שבט נבחו האינדיאני, האל האנדרוגיני שברא את השמים ואת הארץ. מכונה גם "אנדרוגינוס הטורקיז".
Ahulane	<B>(ש"פ)</B> אוולן. אל מלחמה במיתולוגיה של המאיה. נקרא גם "הקָשַת". מקדש לאוולן נמצא באי קוסומל בקריביים של מקסיקו.
Ahura	<B>(ש"פ)</B> אהורה. "אדון". כינוי לאלים בפרס העתיקה, להבדיל מדייבה, ישויות אלוהיות מסוג שונה.
Ahura Mazda|Ohrmazd|Ormazd|Ormuzd	<B>(ש"פ)</B> אהורה מזדה. נקרא גם אורמזד. בנו של זורבן, "אדון החוכמה", האל העליון במיתולוגיה הפרסית, שברא את השמים ואת הארץ. הוא אל הנבואה, החזיונות והחוכמה הדתית. בנו אטר כבל את דרקון השמים להר גדול.
Ahurani	<B>(ש"פ)</B> אהורני. "בת האהורה". אלת המים, הגשמים, הצמיחה והרפואה במיתולוגיה הפרסית. היא בתו ואשתו של אהורה מזדה, אל הבריאה והטוב.
Ai|Aoi Mac Ollamain	<B>(ש"פ)</B> אַי. משורר אירי, מן הטואטה דה דנאן.
Ai Apaec	<B>(ש"פ)</B> אי אפייק. האל העליון של המוצ'יקנים בפרו. הוא חי בין בני האדם והיה לא אל ולא אדם. מיומן כל המלאכות מטוויה ואריגה דרך דיג וציד ועד לאמנות הלחימה. מגן בני האדם, הערפדים, השדים והנחשים. הכלב ידידו והלטאה משרתת אותו. במקורו אל חתול, שקיבל מאוחר יותר גם מאפיינים אנושיים.
Ai Tojon	<B>(ש"פ)</B> אי טוג'ון. הנשר הדור ראשי בורא העולם במיתולוגיה של שבט יקוט הסיבירי. הוא מקנן בצמרת עץ העולם.
Aibell	<B>(ש"פ)</B> אייבל. אלת פיות במיתולוגיה הקלטית אירית.
Aide|Aideko	<B>(ש"פ)</B> איידה. רוח האויר במיתולוגיה הבסקית. נקראת גם אידֶקו.
Aigamuxa	<B>(ש"פ)</B> איגמוסה. במיתולוגיה של שבט חויחוי (דרום אפריקה), מפלצות אוכלות אדם השוכנות בדיונות החול.
Aillen	<B>(ש"פ)</B> איילן. מפלצת שאול במיתולוגיה האירית קלטית.
Aimend	<B>(ש"פ) </B>איימנד. אלת שמש אירית קלטית.
Aine	<B>(ש"פ) </B>איינה. אלת האהבה והפריון האירית קלטית ומלכת הפיות של מחוז לימריק באירלנד.
Ainia	<B>(ש"פ)</B> איניה. במיתולוגיה היוונית, אויבת של הגיבור אכילס, שנלחמה בטרויה לצד פנתליסה.
Aion	<B>(ש"פ)</B> איון. על פי הקלאסיקנים ההלנים, אל פניקי המושל בזמן ובחלוף השנים. ככל הנראה מדובר בשם יווני לאל הכנעני.
Aipaloovik	<B>(ש"פ)</B> איפלוביק. אל ההרס וההרג של האסקימוסים. מתגורר במעמקי הים.
Airitech	<B>(ש"פ)</B> אייריטך. יצור שאול במיתולוגיה הקלטית ואבי שלוש בנות מזדאבות. נהרג בידי הגיבור קאס קוראך.
Airmed	<B>(ש"פ)</B> איירמד. אלה אירית מן הטואטה דה דנאן.
Airts|The Airts|The Four Airts	<B>(ש"ע)</B> ארבע רוחות השמים. זהו המונח הגאלי העתיק לארבעת כיווני המצפן. על פי המסורת הגאלית, הצבע המסמל את המזרח הוא ארגמן השחר, הצבע המסמל את הדרום הוא לובן הצהריים, הצבע המסמל את המערב הוא חום אפרפר של הדמדומים והצבע המסמל את הצפון הוא שחור הלילה.
Airyaman	<B>(ש"פ)</B> איירימן. אל הרפואה והידידות הפרסי.
Aita	<B>(ש"פ)</B> אייטה. אל שאול אטרוסקי.
Aitvaras	<B>(ש"פ)</B> אייטברס. במיתולוגיה הליטואנית, רוח רעה בדמות חתול שחור או תרנגול שחור. שוכן מאחורי האח הביתית ומפתה בני אדם למכור לו את נשמתם. הליטואנים נוהגים להניח לו מנחות פיוס על האח המבוערת.
Aius Locutius|Loquens	<B>(ש"פ)</B> איוס לוקוטיוס. אלוהות שהזהירה את הרומאים מפני פרישת הגלים בשנת 387 לפני הספירה. מקדש נבנה לכבודה בפורום רומנום לאחר הדיפת האויב. נקראת גם לוקואנס.
Aizen-Myoo|Aizen Myo'o|Aizen Myoo	<B>(ש"פ)</B> אייזן מיו. במיתולוגיה היפנית, אל האהבה והאמנות.
Aja	<B>(ש"פ) </B>אג'ה. במיתולוגיה של שבטי יורובה בניגריה, אלת היער ורפואת העשבים.<HR><B>(ש"פ)</B> איה. במיתולוגיה הבבלית, אלת השחר ואשתו של אל השמש.
Ajax|Aias	<B>(ש"פ)</B> איס, אייקס, אג'קס. גיבור יווני, בן טלמון מלך סלמיס. בעזרת האלה אתנה הביס את הקטור במלחמת טרויה, והציל את גופת אכילס. הוא גרר את המכשפה וכהנת הקטה הטרויאנית קסנדרה הרחק מפסל האלה אתנה ולכן נענש. <BR>
Akashic Records	<B>(ש"ע)</B> הרשומות האקשיות. רעיון של אדוארד סייק, לפיו קיים מאגר מידע אוניברסלי במישור האסטרלי, המכיל את כל המידע אודות מאגיה, גלגולים קודמים, רוחניות וריפוי.
Akkadian	<B>(ש"ע)</B> השפה האכדית.<BR><B>(ש"ת)</B> אכדי.
Alaunus	<B>(ש"פ)</B> אלאונוס. אל שמש קלטי. פולחנו התקיים במנהיים ובזלצבורג.
Alban Arthan	<B>(ש"פ) </B>אלבן ארת'ן, 'אור הדב', שמו הגאלי של היפוך החורף, יול. אחד משמונת חגי השמש בגלגל השנה הפגני. נחגג בתאריך 21 לדצמבר.
Alban Eilir	<B>(ש"פ)</B> אלבן אייליר, 'אור האדמה', שמו הגאלי של יום השוויון האביבי, אוסטרה. אחד משמונת חגי השמש בגלגל השנה הפגני. נחגג בתאריך 21 למרץ.
Alban Elfred	<B>(ש"פ)</B> אלבן אלפרד, 'אור המים'. שמו הגאלי של יום השוויון הסתוי, מבון. אחד משמונת חגי השמש בגלגל השנה הפגני. נחגג בתאריך 21 לספטמבר.
Alban Hefin	<B>(ש"פ)</B> אלבן הפין, 'אור הגדה'. שמו הגאלי של יום היפוך הקיץ, מידסאמר. אחד משמונת חגי השמש בגלגל השנה הפגני. נחגג בתאריך 21 ליוני.
Alcyone	<B>(ש"פ)</B> אלקיונה. במיתולוגיה היוונית, בת איאולוס פטרון הרוחות ואשת סייקס, מלך תסליה. השליכה עצמה לים לאחר שנטרפה ספינת בעלה.
Alecto	<B>(ש"פ)</B> אלקטו. אחת משלוש אלות הנקמה היווניות.
Alexandrian	<B>(ש"ת)</B> אלכסנדרי, של מסורת הויקה האלכסנדרית, על פי אלכס סנדרס.
Alexandrian Wicca	<B>(ש"ע)</B> ויקה אלכסנדרית. מסורת ויקנית מיסודו של המכשף אלכס סנדרס.
Alisanos|Alisaunus	<B>(ש"פ)</B> אליסנוס. אל גולי קלטי. מקורו בסיט ד'אור.
Alkonost	<B>(ש"פ)</B> אלקונוסט. ציפור גן העדן במיתולוגיה הרוסית. על פי האגדה, יש לה פנים אנושיות וקול גבוה וצווחני. מדי שבוע היא מטילה את ביציה על חוף הים ואחר כך נושאת אותם אל המים. הביצים מרגיעות את הגלים למשך שבעה ימים. הרוסים מאמינים, כי מי שישמע את קולה של האלקונוסט ישכח את כל מה שהוא יודע.
All Power	<B>(ש"ע)</B> אחד מן השמות המאגיים לכוח האלוהי הבורא האחד.
Alpheus	<B>(ש"פ) </B>אלפאוס. בדת ההלנית, אל נהר האלפאוס הזורם באיים הפלופונזיים ביוון.
Alrune	<B>(ש"פ)</B> אלרון. אחת מרוחות האמהות של ההונים המשנה צורתה, מסייעת בניבוי העתיד ומגנה על הבית.
Amaethon	<B>(ש"פ)</B> אמאתון. אל החקלאות הוולשי, בן האלה הגדולה דון. בגללו פרצה המלחמה בין אלי העולם התחתון לבין האלים בניה של דון.
Amalthaea|Amalthea	<B>(ש"פ)</B> אמלתיאה. במיתולוגיה היוונית העז המינקת של זאוס בעלת קרן השפע שהפכה לקבוצת כוכבים.<BR>
Amazon	<B>(ש"ע)</B> אמזונה. אחת מבנות שבט נשים לוחמות שישב לחוף הים השחור. נקראה כך מפני שכרתה את שדה השמאלי, כדי להיטיב את אחיזת הקשת בידה.<BR>
Ambisagrus	<B>(ש"פ)</B> אמביסגרוס.אל קלטי מן היבשת (אירופה, בניגוד לאלים הקלטיים מן האיים הבריטיים).
Ammon|Amon	<B>(ש"פ)</B> אמון. אל השמש ואבי האלים בדת המצרית העתיקה.
Amphion	<B>(ש"פ)</B> אמפיון. במיתולוגיה היוונית, בן זאוס ואנטיופה. בעזרת נבל קסום שקיבל מן האל הרמס קבע את האבנים בחומת העיר תבס.
Amphisbaena	<B>(ש"פ)</B> אמפיסבנה. במיתולוגיה היוונית, יצור פלאי בדמות נחש בעל שני ראשים.
Amphitrite	<B>(ש"פ)</B> אלת ים יוונית, אשת פוסידון, אחת מן הנראידות, בנות נראוס ודוריס ונכדת אוקיינוס.
Amphitryon	<B>(ש"פ)</B> אמפיטריאון. במיתולוגיה היוונית, בן אלקיאוס מלך טירניס. הוא הרג בטעות את אלקטריון מלך מיקני ונמלט עם בתו אלקמנה לתביי, שם מצא מקלט בחסות המלך קריאון.
Amun Ra	<B>(ש"פ)</B> אמון רה, אמון רע. אל השמש המצרי, מיזוג של האל אמון והאל רע.<BR>
An|Ansar|Anu	<B>(ש"פ)</B> אן. אל השמים בשומר ואכד. נקרא גם אנו או אנשר.
Anann	<B>(ש"פ)</B> אנאן. אלת אם אירית קלטית ואלת השפע במונסטר. צלע בשילוש הקדוש באדב-מאכה-אנאן.
Anath	<B>(ש"פ)</B> ענת. אלת המלחמה ואלה עלמה בכנען ופניקיה.
Ancamna	<B>(ש"פ)</B> אנקמנה. אלת מים קלטית מן היבשת (אירופה, בניגוד לאלים קלטיים מן האיים הבריטיים).
Andarta	<B>(ש"פ)</B> אנדרטה. אלת פריון ומלחמה קלטית צרפתית.
Andraste|Adraste|Andrasta	<B>(ש"פ)</B> אנדרסטה. אלת מלחמה קלטית. סייעה למלכה בודיקה במרד נגד הרומאים בשנת 61 לספירה.
Andromeda	<B>(ש"פ) </B>אנדרומדה. במיתולוגיה היוונית, נערה שפרסאוס הציל מידי מפלצת הים. הפכה לסלע.
Anextiomarus	<B>(ש"פ)</B> אנקסטיומרוס. אל שבטי בריטי קלטי.
Annwn|Annwfn|Annwyfn|Annwyn	<B>(ש"פ)</B> אנוּן. העולם התחתון במיתולוגיה הוולשית קלטית.
Antaeus	<B>(ש"פ) </B>אנטיאוס, אנטיוס, אדני שדה. במיתולוגיה היוונית ענק ארץ לוב, בן פוסידון וגיאה. לא ניתן היה לנצחו כל עוד היה עומד על הארץ ורגליו נגעו בגופה של אמו, אמא אדמה גיאה. הרקולס הרים אותו באויר והרגו.
Antigone	<B>(ש"פ)</B> בת אדיפוס המלך שקברה את אחיה הבוגד למרות צו דודה, המלך קריאון ונידונה למוות.
Anu|An|Ana|Ansar	<B>(ש"פ) </B>אנו. אל השמים בשומר ואכד. נקרא גם אן או אנשר.<HR><B>(ש"פ) </B>אנו. אם פריון אירית קלטית ואם האלים. פולחנה התקיים בעיקר במונסטר.
Anubis	<B>(ש"פ) </B>אנוביס. אל המוות המצרי.
Aphrodite	<B>(ש"פ) </B>אפרודיטה. אלת האהבה, היופי והארוטיקה היוונית.
Apis	<B>(ש"פ)</B> אפיס. אל פר מצרי.
Apkallu|Abgal	<B>(ש"פ)</B> אפכלו. במיתולוגיה האכדית, שבעת אנשי הדגים החכמים שעלו מן המים המתוקים של אפסו והמשרתים את אנקי אל המים והחוכמה. <BR>
Apollo	<B>(ש"פ)</B> אפולו, אפולון. אל השמש היווני.
Aquarius	<B>(ש"ע)</B> דלי, מזל דלי, בית דלי. המזל ה-11 בגלגל המזלות.
Arabian Bird	<B>(ש"ע)</B> עוף החול, פניקס.
Arachne	<B>(ש"פ) </B>ארכנה. במיתולוגיה היוונית, בת אידיון מלידיה, פטרונית העכבישים. היא היתה מיומנת מאוד באומנות הטוויה. היא לעגה לאתנה אלת הטוויה והאריגה, כשהועלתה ההשערה שלמדה ממנה את אומנותה. לכן הפכה אותה אתנה לעכביש.<BR>
Aradia	<B>(ש"פ) </B>ארדיה. במיתולוגיה הביניימית, בתה של האלה דיאנה ואלת המכשפות. אלה מרכזית בדת הויקה.
Arawn	<B>(ש"פ)</B> ארוון. אל השאול הוולשי קלטי.
Arduinna	<B>(ש"פ)</B> ארדווינה, ארדואינה. אלת ירח, ציד ויערות גולית קלטית. חזיר הבר קדוש לה.
Ares	<B>(ש"פ)</B> ארס. אל מלחמה ושפיכות דמים יווני.
Arethusa	<B>(ש"פ)</B> ארתוסה. נראידה (נימפת יער) שהאלה ארטמיס הפכה לנחל כדי לסייע לה להימלט מחיזורי אל הנהר אלפאוס.
Argo	<B>(ש"פ)</B> ארגו. במיתולוגיה היוונית, שם הספינה בה יצא יסון לחפש אחר גיזת הזהב.
Argon	<B>(ש"פ)</B> ארגון. נער מן האי קוס. הוא ואחיותיו לעגו לאלים ולכן הפכו לציפורים.
Argonaut	<B>(ש"פ)</B> ארגונאוט. במיתולוגיה היוונית, אחד המלחים שיצאו עם יסון על סיפון הארגו לחפש אחר גיזת הזהב.
Argus	<B>(ש"פ)</B> במיתולוגיה היוונית, בן זאוס וניאובה. היו לו מאה עיניים. האל הרמס הרדים אותן בנגינת נבל קסומה, עקר אותן וקבע אותן בזנב הטווס.
Ariadne	<B>(ש"פ)</B> אריאדנה. במיתולוגיה היוונית, בת מלך מינוס שסייעה לתזאוס למצוא את דרכו בלבירינת שבנה אביה ולהרוג את המינוטאור.
Arianrhod	<B>(ש"פ)</B> אריאנרוד. אלת ירח וולשית-קלטית . פירוש שמה בגאלית 'הגלגל הכסוף'.
Aries	<B>(ש"ע)</B> טלה, מזל טלה, בית טלה. המזל ה-1 בגלגל המזלות.
Aristaeus	<B>(ש"פ)</B> אריסטיוס. אל הגפנים, הדבורים, הצאן והרועים היווני, בנו של אל השמש אפולו.
Arnemetia	<B>(ש"פ) </B>ארנמנטיה. אלת מים בריטית קלטית.
Artemis	<B>(ש"פ) </B>ארטמיס. אלת הירח, הציד, הבתולין והלידה היוונית. בת זאוס ולטו, ואחותו התאומה של אפולו, אל השמש.
Arthur	<B>(ש"פ)</B> ארתור. מלך אגדי בהיסטוריה של בריטניה.
Arthurian Wicca	<B>(ש"ע)</B> ויקה ארתורית. מסורת ויקה ולשית, המבוססת על המיתולוגיה של המלך ארתור.
Artio|Artio of Muri	<B>(ש"פ)</B> ארטיו. אלת דובים קלטית מן היבשת (אירופה, בניגוד לאלים קלטיים מן האיים הבריטיים).
Arvernus	<B>(ש"פ)</B> ארוורנוס. במיתולוגיה הגאלית קלטית, האל הפטרון של ארוורני.
Asatru	<B>(ש"פ)</B> אסטרו. דת מודרנית המבוססת על המסורות הקדם-נוצריות של צפון אירופה וסקנדינביה.
Ashur	<B>(ש"פ)</B> אשור. האל העליון של ממלכת אשור.
Assyria	<B>(ש"פ)</B> אשור (ממלכה עתיקה באזור עירק של היום).
Astarte	<B>(ש"פ)</B> אסתרת, עשתרת. האלה האם הפניקית ואלת הפריון, המיניות, האמהות, הירח, הים והמים. פטרונית העיר אילת.
Astraea	<B>(ש"פ)</B> אסטריאה. אלת המשפט והצדק היוונית.<HR><B>(ש"ע)</B> מזל בתולה.
Atalanta	<B>(ש"פ) </B>אטלנטה. במיתולוגיה היוונית, ציידת קלת רגליים.
Atar	<B>(ש"פ)</B> אטר. אל האש והטהרה במיתולוגיה הפרסית. בנו של האל העליון אהורה מזדה. אטר נלחם באזהי דהקה, דרקון השמים הנורא וכבל אותו בשלשלאות להר גבוה. הפרסים האמינו כי הדרקון ישתחרר מכבליו וישמיד את האנושות השלישית לפני יום הדין. לאחר מכן ייהרג הדרקון.
Athena	<B>(ש"פ)</B> אתנה. אלת החוכמה, הצדק ומלחמת ההגנה היוונית. פטרונית העיר אתונה, שנקראת על שמה.
Atho	<B>(ש"פ)</B> אתו. שם שניתן לראש מגולף של האל המקורנן בדתות הכשפים כגון ויקה. היה ברשותו של ריימונד האוורד מנורפולק, אנגליה.
Atlantis	<B>(ש"פ)</B> אטלנטיס. על פי אפלטון, אי אגדי ששקע באוקיינוס האטלנטי.
Atlas	<B>(ש"פ)</B> אטלס. במיתולוגיה היוונית, ענק הנושא את העולם על כתפיו.
Atropos	<B>(ש"פ) </B>אטרופוס. אחת משלוש אלות הגורל היווניות. חותכת את חוט החיים.
Attis	<B>(ש"פ)</B> אטיס. אל הצמיחה האנטולי, בן זוגה של אלת הפריון הגדולה קיבלי.
Aufaniae	<B>(ש"פ)</B> אאופאניה. מונח המתאר קבוצת אלות אם קלטיות מן היבשת (אירופה, בניגוד לאלים קלטיים מן האיים הבריטיים).
Augean stables	<B>(ש"פ)</B> רפתות אוגיאס. רפתות המלך אוגיאס, שלא נוקו משך שלושים שנה. אחת ממשימותיו של הרקולס היתה לנקותן. הוא עשה זאת על ידי הטיית שני נהרות לתוכן.
Augeas	<B>(ש"פ)</B> אוגיאס. מלך יווני שלא ניקה את רפתותיו משך שלושים שנה. אחת ממשימותיו של הרקולס היתה לנקותן. הוא עשה זאת על ידי הטיית שני נהרות לתוכן.<BR>
Aurora	<B>(ש"פ) </B>אורורה. אלת השחר הרומאית.
Avalloc	<B>(ש"פ)</B> אבלוק. במיתולוגיה הוולשית קלטית, אבי האלה מודרון ומלך אבלון.
Avalon	<B>(ש"פ)</B> אבלון. אי התפוחים במיתולוגיה הארתורית.
Aveta	<B>(ש"פ)</B> אווטה. אלת הלידה והמיילדות הגאלית קלטית.
BTW|British Traditional Wicca	<B>(ש"ע)</B> ויקה בריטית מסורתית. כינוי למסורות הויקה השמרניות בבריטניה (בד"כ ויקה גרדנריאנית או אלכסנדרית), המקפידות על עבודה באסיפות, הכנסה בסוד ושושלות יוחסין.
Baal	<B>(ש"פ)</B> בעל. אל עליון ואל מזג אויר, ברקים, רעמים וצמיחה בפניקיה ובכנען.
Baba Yaga	<B>(ש"פ) </B>באבה יאגה. מכשפה זקנה במיתולוגיה הסלבית.
Babylon	<B>(ש"פ)</B> בבל.
Bacchus	<B>(ש"פ)</B> בכחוס. אל הגפנים והיין הרומאי.
Badb|Badb Catha|Badhbh|Bodb	<B>(ש"פ)</B> באדב. אלת מלחמה אירית קלטית בדמות עורב וצלע בשילוש הקדוש באדב-מאכה-מוריגן.
Balder	<B>(ש"פ)</B> בלדר. אל היופי והתום הצפוני, שנהרג בידי לוקי, אל האש.
Balmung	<B>(ש"פ)</B> בלמונג. במיתולוגיה הגרמאנית, חרבו הקסומה של הגיבור זיגפריד.
Balor	<B>(ש"פ)</B> בְּלור. אל מוות קלטי-אירי ואל הפומורים, גזע ענקים. בן זוגה של האלה דנה או של האלה קייתלן.
Banba	<B>(ש"פ)</B> בנבה. אלה אירית קלטית המייצגת את רוח אירלנד. אשת המלך מק'קוויל וצלע בשילוש הקדוש פודלה-אריו-בנבה.
Bast	<B>(ש"פ)</B> באסט. אלת חתול מצרית.
Beag	<B>(ש"פ)</B> ביג. אלת באר אירית קלטית מן הטואטה דה דנאן.
Bealtaine	<B>(ש"ע)</B> בלתיין. אחד משמונת חגי השמש בגלגל השנה הפגני. נחגג בתאריך 30 לאפריל.
Bean Sidhe	<B>(ש"פ)</B> בן שי. במיתולוגיה הקלטית, רוח המבשרת מוות ביללותיה.<BR>
Bebhionn	<B>(ש"פ)</B> בביון. אלת שאול, עונג והנאה אירית קלטית.
Bel	<B>(ש"פ)</B> שמו האכדי של אל הרוח השומרי אנליל.<HR><B>(ש"פ) </B>כינוי לאל הפניקי בעל.
Bel fire|balefire|belfire	<B>(ש"ע)</B> אש בעל, אש בל, אשבעל. מדורה לכבוד האל בל או בעל. <HR><B>(ש"ע) </B>אשבעל. בהשאלה, מדורה טקסית המודלקת בעת חגיגות פגניות או למטרות מאגיות.
Belatu-Cadros|Belatu Cadros|Belatucadros	<B>(ש"פ)</B> בלטו קדרוס, 'בוהקת ויפהפייה', אלת מלחמה ונקמה באויבים קלטית. פולחנה התקיים בעיקר בווילס.
Belenus|Bel|Belanus|Beli|Bile	<B>(ש"פ)</B> בלנוס. אל אור, רועים ועדרים קלטי. פירוש שמו ככל הנראה 'הבהיר'. אשתו היא האלה בליסמה. חגו השנתי הוא ביום בלתיין, אחד משמונת חגי השמש בגלגל השנה הפגני, נחגג בתאריך 31 לאפריל.
Belisama	<B>(ש"פ)</B> בליסמה. אלת אור, אש, נפחות ומלאכות גולית וקלטית. אשתו של האל בלנוס.
Bellona	<B>(ש"פ) </B>בלונה. אלת המלחמה הרומאית, אחותו של מרס.
Beltane	<B>(ש"פ)</B> בלתיין. אחד משמונת חגי השמש בגלגל השנה הפגני. נחגג בתאריך 30 לאפריל.
Benandanti	<B>(ש"ע)</B> בננדנטי. קבוצה אתנית איטלקית, בעלת מסורת של כשפים עממיים. הבננדנטי נחשבו למטילי כשפים מיטיבים, בניגוד למלנדנטי, מכשפים רעים.
Berecyntia	<B>(ש"פ)</B> ברקינטיה. אלה אם גולית, כנראה מקבילה לאלה הגדולה בריגיד.
Bile	<B>(ש"פ)</B> בִּילֵה. אל אור, רפואה והעץ הקדוש במיתולוגיה האירית. בדרך כלל מקביל לאל בלנוס.
Bird Goddess	<B>(ש"ע)</B> אלת הציפור. אלה ניאוליתית מכונפת, בעלת מקור או גוף של ציפור.
Blarney stone	<B>(ש"ע)</B> אבן בלרני, אבן החנופה. אבן הקבועה בכניסה לארמון בלרני באירלנד. על פי האמונה העממית, מי שינשק אותה ימצא חן בעיני שועי עולם.
Blessed Be	ברוך תהיה, ברוכה תהיי, ברוכים תהיו (ברכה ויקנית נפוצה הלקוחה מטקס הנשיקה המחומשת).
Bloeuwedd	<B>(ש"פ)</B> בלודווד. במיתולוגיה הקלטית, כלה יפהפייה שיצר האשף גווידיון עבור לו לו גייפס. לרוע המזל התאהבה באחר. היא ומאהבה ניסו להרוג את לו. הוא הפך לנשר ובלודווד הפכה לינשוף.
Blood of the Moon	<B>(ש"ע)</B> דם הירח. כינוי למחזור החודשי הנשי במאגיה. תקופה זו נחשבת טובה במיוחד להטלת כשפים ולמעשיים מאגיים, במיוחד אם היא חופפת לתקופת הירח החדש או הירח המלא.
Boann	<B>(ש"פ)</B> בואן. 'לבנת הבקר', אלת השפע והפריון האירית קלטית. הפרה הלבנה קדושה לה והנהר בוין נקרא על שמה.
Bodb Dearg	<B>(ש"פ)</B> בודב דירג. במיתולוגיה הקלטית, בנו של דגדה ויורשו כמלך האלים.
Boreas	<B>(ש"פ)</B> בוריאס.
Borvo|Bormanious|Bormanus|Bormo	<B>(ש"פ)</B> בורוו. 'להרתיח', אל המעיינות החמים והמרפא הקלטי. בפרובנס קראו לו בורמנוס ובפורטוגל בורמניוס.
Bow of Ulysses	<B>(ש"ע)</B> קשת יוליסס.
Bran	<B>(ש"פ)</B> ברן. במיתולוגיה הקלטית, בן ליר ופנרדון, אחי בראנוון, מנווידאן, ניסיין ואפניסיין. הציל את אחותו בראנוון מעריצות בעלה.
Branwen	<B>(ש"פ) </B>ברנוון. במיתולוגיה הקלטית, בת מלך שנישאה למתולווך וחיה אצלו חיי עבדות. אחיה בראן יצא להצילה.
Brea	<B>(ש"פ)</B> בריאה. אל אירי מן הטואטה דה דנאן.
Breg|Bregh	<B>(ש"פ)</B> ברג. אלה בריטית, אשתו של דגדה.
Bres	<B>(ש"פ)</B> ברס. אל פריון וחקלאות אירי קלטי. בנו של אלתה, נסיך פומורי ושל האלה אריו.
Briante	<B>(ש"פ)</B> בריאנטה.
Briareus	<B>(ש"פ)</B> בריארוס.
Brid	<B>(ש"פ)</B> בריד. שם אחר לאלה הקלטית בריגיד.
Bride	<B>(ש"פ)</B> ברייד. כינוי לאלה הקלטית בריגיד.
Brigantia	<B>(ש"פ)</B> בריגנטיה. אלת עדרים ובקר קלטית רומאית, האלה הפטרונית של הבריגנטים ביורקשיר ואלת הנהרות ברנט ובריינט.
Bright Blessings	ברכות אור (סוג ברכה ויקנית נפוצה).
Brigid|Bride	<B>(ש"פ)</B> בריגיד. אלה אירית קלטית. נקראת ברייד בסקוטלנד.
Brigid's bed	<B>(ש"ע)</B> ערש בריגיד.
Bronach	<B>(ש"פ)</B> ברונך. אלת צוקים אירית קלטית.
Bussumarus	<B>(ש"פ)</B> בוסומרוס. אל קלטי מן היבשת (אירופה, בניגוד לאלים קלטיים מן האיים הבריטיים).
Cadmus	<B>(ש"פ)</B> קדמוס.
Caer	<B>(ש"פ)</B> קייר. במיתולוגיה הקלטית, עלמת ברבור שאנגוס אל השירה התאהב בה והפך לברבור עבורה.
Cailleach|Cailleach Beara	<B>(ש"פ)</B> קיילך. אלת פריון קלטית, בוראת האדמה ומכשפה גדולה. נחשבת אם כל חי בסקוטלנד.<HR><B>(ש"ע)</B> בפולקלור הקלטי, בובת תירס שמכין האיכר שקוצר את שדהו ראשון ומעביר אותה לאיכר שקוצר את שדהו אחריו. האיכר שקוצר אחרון את השדה, שומר על הבובה עד השנה הבאה.
Calliope	<B>(ש"פ)</B> קליופה.
Calypso	<B>(ש"פ)</B> קליפסו.
Cambria	<B>(ש"פ) </B>קמבריה (שמה העתיק של ווילס).<BR>
Camelot	<B>(ש"פ)</B> קמלוט. ממלכת המלך ארתור בדרום מערב אנגליה.
Camma	<B>(ש"פ)</B> קאמה. אלת הציד הבריטונית.
Camulus|Camulos	<B>(ש"פ)</B> קמולוס. אל מלחמה גולי קלטי. העיר קולצ'סטר נקראת על שמו.
Canaan	<B>(ש"פ)</B> כנען.
Canola	<B>(ש"פ)</B> קנולה. במיתולוגיה הקלטית, ממציאת הנבל האירי.
Carman|Carme	<B>(ש"פ)</B> כרמן. אלת הכשפים המרושעים במיתולוגיה הקלטית. בניה הם דאב (חושך), דות'ר (רשע) ודיאן (אלימות).
Carmen	<B>(ש"פ)</B> כרמן.
Carthage	<B>(ש"פ)</B> קרתגו.
Carthagian apple	<B>(ש"ע)</B> רימון.
Cartimandua	<B>(ש"פ)</B> כרטימנדואה. במיתולוגיה הקלטית, אלה לוחמת ומלכת הבריגנטים, שנאבקה נגד הכיבוש הבריטי.
Cassandra	<B>(ש"פ)</B> קסנדרה. במיתולוגיה היוונית, מכשפה וכוהנת לאלה הקטה. האל אפולו קילל אותה שאיש לא יאמין לנבואותיה. היא ניבאה את נפילת טרויה, אך איש לא שעה לנבואותיה. היא נהרגה כשנפלה העיר.
Castor and Pollux|Castor|Pollux	<B>(ש"ע)</B> קסטור ופולוקס. במיתולוגיה הרומאית, התאומים שייסדו את רומא.<HR><B>(ש"ע) </B>כינוי לתאומים.<HR><BR><B><BR><BR></B><BR><BR><BR>
Caswallawn	<B>(ש"פ)</B> כסוואלון. אל מלחמי בריטי קלטי.
Celaeno|Podarge	<B>(ש"פ)</B> קליינו. אחת משלוש ההרפיות, "השודדות", מפלצות מכונפות בעלות פני אשה זקנה וטפרים חדים ומעוקלים. ההרפיות הן שליחות האלים להענשת בני אדם. הן מענות אותם וגוררות אותם לשאול. קליינו היא "האפלה" וגם "קלת רגליים".
Celt|Kelt	<B>(ש"פ)</B> קלטי.
Celticism|Kelticism	<B>(ש"פ)</B> קלטיות.
Cenn Cruaich	<B>(ש"פ)</B> קן קרואייך אל שמים גאלי קלטי.
Cepheus	<B>(ש"פ)</B> קפאוס.
Cerberus	<B>(ש"פ)</B> קרברוס.
Ceremonial Magic	<B>(ש"ע)</B> מאגיה טקסית. שיטת מאגיה שפותחה בימי הביניים ועיקרה טקסים מפורטים ומדוקדקים.
Ceres	<B>(ש"פ)</B> קרס. אלת הצמיחה, האדמה והגרעינים הרומאית.
Cernunnos|Herne|Hu'Gadarn	<B>(ש"פ)</B> קרנונוס. אל בעל קרניים במיתולוגיה הקלטית. אל פריון, חיים, בעלי חיים, שפע והעולם התחתון.
Cerridwen|Kerridwen	<B>(ש"פ) </B>קרידוון. אלת החוכמה והכשפים הקלטית. בעלת קדרה מופלאה שבעזרתה רקחה שיקוי חוכמה עבור בנה המכוער אבגדו. הבארד טליאסין שתה אותו בטעות.
Cessair	<B>(ש"פ)</B> קסייר. במיתולוגיה הקלטית, מכשפה רבת עוצמה והמלכה הראשונה של אירלנד לאחר המבול.
Cethlion	<B>(ש"פ)</B> קתליון. במיתולוגיה הקלטית, נביאת הפומורים, שחזתה את מפלתם בידי הטואטה דה דנאן.
Chaldean	<B>(ש"פ)</B> כשדי.
Chaldee	<B>(ש"ע) </B>השפה הכשדית.
Chaos Magic	<B>(ש"ע)</B> כשף כאוס. שיטה מאגית.
Charge of the God	<B>(ש"ע)</B> מצוות האל. אחד מאסופה של טקסטים ויקנים הנקראים בשם זה.
Charge of the Goddess|The Charge	<B>(ש"ע)</B> מצוות האלה. טקסט ויקני שנאמר במהלך טקס הורדת הירח.
Charities	<B>(ש"פ)</B> בנות החן, בנות החסד, הגרציות. שלוש אלות אחיות במיתולוגיה היוונית.
Charon	<B>(ש"פ)</B> כרון.
Chimera	<B>(ש"פ)</B> חימרה.
Chloe	<B>(ש"פ)</B> קלואי, כלואה.
Chronos	<B>(ש"פ)</B> כרונוס, קרונוס.
Chtonia	<B>(ש"פ)</B> כתוניה. רוחות האדמה והעולם התחתון במיתולוגיה היוונית.
Circe	<B>(ש"פ)</B> קירקה. במיתולוגיה היוונית, מכשפה וכהנת לאלה הקטה.
City of the Seven Hills	<B>(ש"ע)</B> רומא.
Cleopatra's Needle	<B>(ש"פ)</B> מחט קליאופטרה (אובליסק)
Cliodhna	<B>(ש"פ)</B> קלינה. אלת היופי הקלטית ומלכת הפיות במחוז קורק באירלנד.
Clota	<B>(ש"פ)</B> קלוטה. אלת הנהר קלייד הקלטית.
Cocidius	<B>(ש"פ)</B> קוסידיוס. אל ציד קלטי מצפון בריטניה.
Colossus	<B>(ש"פ)</B> קולוסוס.
Comus	<B>(ש"פ)</B> קומוס.
Conall Cernach	<B>(ש"פ)</B> קונאל קרנאך. לוחם אמיץ מן המיתולוגיה האירית קלטית. פירוש שמו 'חזק ומנצח'.
Conchobar	<B>(ש"פ)</B> קונקובאר. במיתולוגיה האירית חתן שכלתו דירדרה ברחה עם מאהבה נויסי. קונקובאר הרג את נויסי ואת כל אחיו ודירדרה מתה מצער.
Condatis	<B>(ש"פ)</B> קונדטיס. אל נהר ומים קלטי בריטי.
Contrebis	<B>(ש"פ)</B>קונטרביס. אל קלטי רומאי, פטרון אזור לנקסטר בבריטניה.
Corb	<B>(ש"פ)</B> קורב. אל אירי מגזע הפומורים.
Cormac Mac Airt	<B>(ש"פ)</B> קורמק מק איירט. מלך אגדי אירי, שחי במאה השלישית לספירה. על פי האגדה, קיבל גביע קסום מאל הים מננן מק ליר.
Coventina	<B>(ש"פ)</B> קובנטינה. אלת מים ומעיינות קלטית מאזור קרבורג. באזור באר המקודשת לה והיא נחשבת אלת מים מרפאים.
Creiddylad	<B>(ש"פ)</B> קריידילד. אלה וולשית, בתו של אל הים ליר. מופיעה במחזה 'המלך ליר' של שייקספיר כקורדליה, בת המלך ליר.
Creidhne	<B>(ש"פ)</B> קריידנה. אל הנפחים וחרשי המתכת הקלטי. אחד משלושת אלי האומנות של הטואטה דה דנאן, עם גויבניו ולוכטה.
Crete	<B>(ש"פ)</B> כרתים.
Crom Cruach|Cromm Cruac	<B>(ש"פ)</B> קרום קרואך. פסל ענקי באולסטר, אירלנד, כנראה של אלוהות שמש. סביבו היו שנים עשר פסלונים קטנים יותר עשויים אבן או זהב. הוקרבו לו ילדים בסו-ווין, אחד משמונת חגי השמש בגלגל השנה הפגני כדי להבטיח את פוריות האדמה והבהמות לשנה הבאה.
Cu Roi	<B>(ש"פ)</B> קו רוי. במיתולוגיה האירית, מכשף שהיה מסוגל לשנות את צורתו.
Cuchulainn|Cu Chulainn|Cuchulain|Setanta	<B>(ש"פ) </B>קוכוליין. בנו הגיבור של לו שדחה את חיזורי המוריגן ולכן נהרג בקרב.
Cupid	<B>(ש"פ)</B> קופיד, קופידון. אל האהבה הרומי, בנו של מרקורי.
Curoi mac Daire	<B>(ש"פ)</B> קורוי מק דייר. אל שמש וסערות קלטי בדמות ענק חמוש בגרזן.
Cwn Annwn	<B>(ש"פ)</B> קוּן אנוּן. כלבי אל השאול אנון במיתולוגיה הבריטונית קלטית.
Cybele|kybele	<B>(ש"פ)</B> קיבלי. אלת פריון גדולה באסיה הקטנה.
Cyhiraeth	<B>(ש"פ) </B>קיראיית. אלת נחלים קלטית ומבשרת מוות בצווחות.
Cynosura	<B>(ש"פ)</B> קינוסורה. במיתולוגיה היוונית, נימפה שטיפלה בזאוס התינוק כשהיה על ריאה אמו להחביאו מכרונוס אביו שרצה להרגו. היא הסתירה את זאוס בעריסה שתלתה על עץ.
Cyntefyn	<B>(ש"פ) </B>קינטפין. שם אחר לחג בלתיין. אחד משמונת חגי השמש בגלגל השנה הפגני. נחגג בתאריך 30 לאפריל.
Daedalus	<B>(ש"פ)</B> דידלוס, דדלוס. במיתולוגיה היוונית, בונה הלבירינת, שהפך לאל לאחר מותו.
Dagda|Cian|Dadge|Daghda|Dagodevas|The Dagda	<B>(ש"פ)</B> דגדה. הדגדה. אל הארץ, האדמה, ההסכמים והכשפים הקלטי. מושל בחיים ובמוות ואחד מן האלים הגדולים של הטואטה דה דנאן. פירוש שמו 'הטוב והמיטיב'. הוא בנה של דנו, בעלה של המוריגן ואביהם של בריגיד ואגנוס.
Damara	<B>(ש"פ)</B> דמרה. אלת פריון בריטית קלטית ואלת חודש מאי.
Damocles	<B>(ש"פ)</B> דמוקלס.
Damona	<B>(ש"פ)</B> דמונה. אלת פריון ופרות גלית קלטית. אשתו של בורוו.
Dana|Danu	<B>(ש"פ)</B> דנה. אלה קלטית.
Danaides	<B>(ש"פ)</B> הדנאידות (במיתולוגיה היוונית, אחיות שהרגו כולן פרט לאחת את בעליהן, בפקודת אביהן דנאוס).
Danaus	<B>(ש"פ)</B> דנאוס. אבי הדנאידות, הורה לבנותיו להרוג את בעליהן.
Danu|Dan|Dana|Dann	<B>(ש"פ)</B> דנו. אלה אם קלטית אירית ואם אלי הטואטה דה דנאן ('אנשי האלה דנו').
Dea Matrona	<B>(ש"פ)</B> דאה מטרונה. אלה קלטית ממקור הנהר מרן בצפון צרפת.
Decent of the Goddess	<B>(ש"ע)</B> פרשת ירידת האלה לשאול.
Dechtere	<B>(ש"פ)</B> דכטרה. אם הגיבור קוכוליין במיתולוגיה האירית.
Deianira	<B>(ש"פ)</B> דיאנירה. במיתולוגיה היוונית, נסיכה ואשתו של הרקולס. הרקולס זכה בה לאחר קרב עם אל הנהר אכלואוס. דיאנירה הביאה למותו של הרקולס בטעות. היא נתנה לו ללבוש גלימה ספוגה בדמו הרעיל של הקנטאור נסוס, מפני שחשבה שהדבר יבטיח את אהבת בעלה.
Deirdra	<B>(ש"פ)</B> דירדרה. במיתולוגיה הגאלית קלטית, כלתו היפהפייה של קונקובאר מלך אולסטר שברחה עם מאהבה. היא מתה מצער לאחר שקונקובאר הרג את אהובה ושני אחיו.
Demeter	<B>(ש"פ)</B> דמטר. אלת האדמה והפריון היוונית.
Dewi	<B>(ש"פ)</B> דווי, דואי. אל וולשי קלטי קדום, המייצג את רוחה וריחונתה של ווילס בדמות נחש ענק ואדום.
Dia Griene	(ש"פ) דיה גריאנה. בת השמש במיתולוגיה הסקוטית.
Dian Cecht	<B>(ש"פ)</B> דיאן קכט. אל הרפואה והרופאים האירי קלטי, מן הטואטה דה דנאן.
Diana	<B>(ש"פ)</B> דיאנה. אלת היערות וחיות הבר הרומאית.
Dianic Wicca	<B>(ש"ע)</B> ויקה דיאנית. מסורת ויקה נשית-לסבית.
Dionysia	<B>(ש"פ) </B>דיוניסיה, חגיגת דיוניסוס.
Dionysos	<B>(ש"פ)</B> דיוניסוס. אל היין והשכרות היווני.
Dis	<B>(ש"פ)</B> דיס. שם שנתן יוליוס קיסר לאל הראשי של הקלטים כשכבש את גליה. לא ברור באיזה אל מדובר.
Don	<B>(ש"פ)</B> דון. אלה אם וולשית, אשתו של בלי ואם גווידיון.
Drawing Down the Moon	<B>(ש"ע)</B> הורדת הירח (טקס ויקני).
Drawing Down the Sun	<B>(ש"ע)</B> הורדת השמש (טקס ויקני).
Dropys|King Dropys	<B>(ש"פ) </B>דרופיס. מלך יווני וסבו של האל פאן. פאן רעה את עדריו.
Dryope	<B>(ש"פ)</B> דריופה. במיתולוגיה היוונית, אשת המלך דריפוס, אם פאן ובת הרמס.
Dwyn|Dwynwen	<B>(ש"פ)</B> דווין, דואין. אל אהבה קלטי.
Dylan	<B>(ש"פ)</B> דילן. 'הים', בנה של אלת הירח אריאנרוד שנולד בלידת בתולין. הוא יצור מימי, ששב אל הגלים מיד עם לידתו. כשחזר לאדמה לאחר זמן רב, נהרג על ידי דודו גובנון, שלא הכיר אותו.
Ea	<B>(ש"פ)</B> אאה. אל המים והמעמקים השומרי והאכדי.
Echo	<B>(ש"פ)</B> אקו. נימפה שהפכה להד.
Edain	<B>(ש"פ)</B> אדיין. אלת הרכיבה על סוסים הקלטית.
Egeria	<B>(ש"פ)</B> אגריה.
Elaine|Dame Elaine|Elaine of Corbenic|Lad of Shalott|Lady Elaine|Lady of Shallot|The Lady of Shallot|The Lady of Shalott	<B>(ש"ע)</B>. איליין. במיתולוגיה הארתורית הגבירה איליין מקורבניק היא בת אצולה שהתאהבה בסר לנסלוט של האגם. גווינביר אשת ארתור ומאהבתו של לנסלוט גירשה אותה מחצר המלכות. המשורר אלפרד טניסון כתב פואמה מפורסמת המבוססת על האגדה, אך פרטי העלילה אצלו שונים. על פי טניסון, ליידי איליין היא גבירת שאלוט, בילתה את ימיה כלואה בחדרה. קללה שהוטלה עליה מנעה ממנה לצאת החוצה או אפילו להביט במתרחש מחוץ לכתלי מבצרה. יום אחד ראתה את דמותו של לנסלוט של האגם רוכב מחוץ לחלונה בהשתקפות מראה שהחזיקה. היא לא יכלה לעצור בעד עצמה, יצאה החוצה והביאה על עצמה כליה.
Electra	<B>(ש"פ)</B> אלקטרה.
Elen	<B>(ש"פ)</B> אלן. גיבורה וולשית שבנתה דרכים לחיילים שהגנו על ארצה.
Eleusinian Mysteries	<B>(ש"ע)</B> פולחני המסתורין האלבסיים.
Elysian Field	<B>(ש"ע)</B> שדות אליסיום.
Elysium	<B>(ש"פ)</B> אליסיום.
Emer	<B>(ש"ע)</B> אמר. אשה יפהפייה וחכמה במיתולוגיה הקלטית. היא דרשה מקונקובאר מלך אולסטר שיבצע שורת משימות לפני שהסכימה להתעלס עמו.
End of the World	<B>(ש"ע)</B> קץ כל בשר, קץ העולם, סוף העולם.
Endymion	<B>(ש"פ)</B> אנדימיון. במיתולוגיה היוונית, אהובה של אלת הירח סלין, שכושף לישון שנת נצח.
Eostra|Osatra	<B>(ש"פ)</B> אוסטרה, השתוות אביבית. אחד משמונת חגי השמש בגלגל השנה הפגנית. נחגג בתאריך 21 למרץ.
Eostre	<B>(ש"פ)</B> אוסטרה. אלת האביב, הלידה והשחר הגרמאנית והאנגלו סקסית. חגיגת השוויון האביבי נקראת על שמה ומשם החגיגה נגזר גם שם חג הפסחא באנגלית.
Epimetheus	<B>(ש"פ)</B> אפימתאוס.
Epona	<B>(ש"פ)</B> אפונה. אלת סוסים ורכיבה קלטית. מקורה בגליה, אך פולחנה נפוץ בכל רחבי אירופה והיא היתה האלה הקלטית היחידה, שנבנה לכבודה מקדש ברומא.
Erato	<B>(ש"פ)</B> ארטו.
Erebus	<B>(ש"פ)</B> ארבוס.
Eri	<B>(ש"פ)</B> ארי. במיתולוגיה הקלטית, אמו של אל החלקאות והפריון ברס.
Erinys	<B>(ש"פ)</B> אריניות, בנות הנקם.
Eris	<B>(ש"פ)</B> אריס.
Erlking|Erlkin|Erlkonig	<B>(ש"פ)</B> ארלקינג, ארלקין. במיתולוגיה הגרמאנית, רוח רעה החוטפת ילדים בלילה.
Eros	<B>(ש"פ)</B> ארוס. אל האהבה היווני.
Erse	<B>(ש"פ)</B> גלית סקוטית, גלית אירית.
Esbat	<B>(ש"פ)</B> אסבת, מועד לבנה, ליל ירח מלא.<HR><B>(ש"פ) </B>אסבת. בהשאלה, כל התכנסות מכשפות, שאיננה נערכת באחד משמונת חגי השמש בגלגל השנה הפגני.
Eumanides	<B>(ש"פ)</B> דורשות טוב (לשון סגי נהור לבנות הנקם).
Euphrosyne	<B>(ש"פ)</B> אפרוסיני.
Europa	<B>(ש"פ)</B> אירופה.
Eurydice	<B>(ש"פ)</B> אורידיקי.
Excalibur	<B>(ש"פ)</B> אקסקליבר. חרבו הקסומה של ארתור, מלך בריטניה האגדי.
Eye of Horus	<B>(ש"ע)</B> עין הורוס.
Faeri Wicca|Feri Wicca	<B>(ש"ע)</B> פרי ויקה. מסורת ויקה גברית-הומוסקסואלית.
Fatal Sisters|Fates|The Fatal Sisters|The Fates|The Three Fatal Sisters	<B>(ש"ע)</B> בנות הגורל. במיתולוגיה היוונית, שלוש אלות אחיות, הטוות וחותכות את חוט החיים.
Father Neptune	<B>(ש"ע)</B> האוקיינוס.
Fivefold Kiss	<B>(ש"ע)</B> הנשיקה המחומשת. טקס ויקני שבמהלך הורדת הירח.
Frey	<B>(ש"פ)</B> פריי. אל הצמיחה הסקנדינבי.
Freya|Frea|Frija	<B>(ש"פ)</B> פרייה, אלת הפריון, המלחמה, החוכמה והכשפים הסקנדינבית.
Gaea|Gaia|Gea|Gia	<B>(ש"פ)</B> גאה, גאיה. אלת האדמה במיתולוגיה היוונית. <HR><B>(ש"ע) </B>אמא אדמה.
Galatea	<B>(ש"פ)</B> גלטיאה.
Ganieda	<B>(ש"פ)</B> גניאדה. אחות המלך ארתור, שניחנה בכוחות נבואיים.
Gard	<B>(ש"ע)</B> גרדנריאני. כינוי לאדם החבר באסיפה ויקנית בריטית מסורתית המיוחסת בשושלת הכנסות בסוד לג'רלד גרדנר.
Gardnerian	<B>(ש"ת)</B> גרדנריאני. של מסורת הויקה הגרדנריאנית מיסודו של המכשף ג'רלד גרדנר.<HR><B>(ש"ע)</B> גרדנריאני. כינוי לאדם החבר באסיפה ויקנית בריטית מסורתית המיוחסת בשושלת הכנסות בסוד לג'רלד גרדנר.<BR>
Gardnerian Wicca	<B>(ש"ע)</B> ויקה גרדנריאנית.
Gemini	<B>(ש"ע)</B> תאומים, מזל תאומים, בית תאומים.
God's Wife	<B>(ש"ע)</B> אשת האל. כינוי לכוהנת הגדולה לאל אמון בעיר תבי במצרים העתיקה. נחשבה להתגלמות האלה חתור. עמדה בראש כוהנות הנגינה והמחולות, "הרמון האל", שעבדו גם את האלה איזיס.
Goetia	<B>(ש"ע)</B> גואטיה. שיטה מאגיה נמוכה יוונית.
Golden Fleece	<B>(ש"ע) </B>גיזת הזהב (במיתולוגיה היוונית).
Gorgone	<B>(ש"פ)</B> גורגון, גורגונה. יצור מפלצתי בעלת שערות נחשים, במיתולוגיה היוונית.
Gotterdammerung	<B>(ש"ע)</B> דמדומי האלים. קץ העולם במיתולוגיה הגרמאנית.
Graea|Graiae	<B>(ש"פ)</B> הגריאות.
Great Master	<B>(ש"ע)</B> מסטר גדול. אחת מן הדרגות הגבוהות במסדרים המיסטיים של המאגיה הטקסית.
Green Man	<B>(ש"פ)</B> האיש הירוק. אל היערות והעלווה במיתולוגיה הקלטית.
Guardians	<B>(ש"ע)</B> שומרים. מכשפים טקסיים העובדים עם אדוני מגדלי השמירה, השומרים של ארבע רוחות השמים.
Gwydion	<B>(ש"פ)</B> מסורת פגנית מאגית המתייחסת
Gwydion the Wizard|Gwydion	<B>(ש"פ)</B> גווידיון האשף, גדעון האשף.
Hades	<B>(ש"ע)</B> האדס. אל השאול במיתולוגיה היוונית.
Hard Gard	<B>(ש"ע)</B> גרדנריאני מחמיר. כינוי לגרדנריאנים בעלי תפיסות נוקשות לגבי אילו מסורות ואסיפות נחשבות ויקניות תקפות ואילו לאו, אילו מסורות נחשבות גרדנריאניות ואילו לאו וכן הלאה. גרדנריאני הוא אדם החבר באסיפה ויקנית בריטית מסורתית המיוחסת בשושלת הכנסות בסוד לג'רלד גרדנר.<BR>
Hathor	<B>(ש"ע)</B> חתור. אלת הפריון המצרית.
Hebe	<B>(ש"ע)</B> הבה.
Hecate	<B>(ש"ע)</B> הקטה.
Hecate Trivia	<B>(ש"ע)</B> הקטה טריויה (הקטה של שלוש הדרכים). כינויה של הקטה כאלת הצטלבויות שלוש דרכים, המסמלות את העבר ההווה והעתיד ואת העלמה האם והסבתא.
Hel	<B>(ש"פ)</B> הל. אלת השאול הסקנדינבית.
Helen of Troy|Helen	<B>(ש"פ)</B> הלנה מטרויה, הלנה היפה. במיתולוגיה היוונית, בת זאוס ולדה (או נמסיס), אחות קליטמנסטרה אשת אגממנון, ואשת המלך מנלאוס, אחיו הצעיר של אגממננון. יופיה גרם לפרוץ מלחמת טרויה.
Helenismos	<B>(ש"פ)</B> הלניסמוס. הדת היוונית העתיקה.
Helice	<B>(ש"פ)</B> הליסה. במיתולוגיה היוונית, נימפה שטיפלה בזאוס התינוק כשהיה על ריאה אמו להחביאו מכרונוס אביו שרצה להרגו. היא הסתירה את זאוס בעריסה שתלתה על עץ.
Helios	<B>(ש"פ)</B> הליוס. אל השמש היווני הקדום.
Hellas	<B>(ש"ע)</B> הלאס, יוון.
Hellenism	<B>(ש"ע)</B> הלניזם, הלניות, התרבות היוונית.
Hera|Here	<B>(ש"פ)</B> הרה. אלת האמהות והנישואין היוונית, אשת זאוס ופטרונית הנשים הנשואות.
Hercules|Heracles	<B>(ש"ע)</B> הרקולס, הרקלס. גיבור במיתולוגיה היוונית.
Hermaphroditus	<B>(ש"ע)</B> הרמפרודיטוס.
Hermes	<B>(ש"ע)</B> הרמס.
Hermes Trismegistus	<B>(ש"ע)</B> הרמס טריסמגיסטוס.
Hermetica	<B>(ש"ע)</B> הרמטיקה.
Hermione	<B>(ש"ע)</B> הרמיוני, הרמיונה.
Herne	<B>(ש"ע)</B> הרן.
Herne the Hunter	<B>(ש"ע)</B> הרן הצייד.
Hero and Leander	<B>(ש"ע)</B> הרו וליאנדר.<HR><B>(ש"ע) </B>כינוי לזוג אוהבים ותיק.
Hestia	<B>(ש"ע)</B> הסטיה. אלת האח והאש הרומאית.
Hierarch	<B>(ש"ע)</B> הירארך. בדת היוונית, הכהן הממונה על הקרבנות בהלאס.
High Magic	<B>(ש"ע)</B> מאגיה גבוהה. כינוי לשיטות מאגיות שונות שעיקרן עבודה עם רוחות, שדים ומלאכים.
Hittite	<B>(ש"ע)</B> חיתים, העם החיתי, השפה החיתית<BR><B>(ש"ת)</B> חיתי
Holda|Holde|Holle|Hulda	<B>(ש"ע)</B> הולדה.
Holly King	<B>(ש"ע)</B> מלך צינית.
Holy City	<B>(ש"ע)</B> עיר הקודש (כינוי לערים רומא וירושלים).
Horned God	<B>(ש"ע)</B> האל בעל הקרניים.
Horus	<B>(ש"ע)</B> הורוס. האל העליון במצרים.
Hunting Lodges	<B>(ש"ע)</B> לשכות ציידים. כינוי לאגודות מאגיות בבריטניה העוסקות בשיטור אסטרלי.
Hyades	<B>(ש"ע)</B> הידס, היאדס.
Hydra	<B>(ש"ע)</B> הידרה.
Hyksos	<B>(ש"ע)</B> ההיסקסוסים (שושלת מלכים מצריים).
Hypnos	<B>(ש"ע)</B> היפנוס. אל השינה היווני.
Icarus	<B>(ש"ע)</B> איקרוס. במיתולוגיה היוונית נער שאביו עשה לו כנפיים משעווה. הוא עף קרוב מדי לשמש ולכן נפל לים וטבע.
Ides	<B>(ש"ע)</B> אידים. חגים רומאיים באמצע החודש.
Illiad	<B>(ש"ע)</B> איליאדה.
Imbolc|Imbolg Oimelc	<B>(ש"ע) </B>איבולג, אימבולק, אוימלק. אחד משמונת חגי השמש בגלגל השנה הפגני. נחגג בתאריך 2 בפברואר.
Io	<B>(ש"ע)</B> איו.
Iolite	<B>(ש"ע)</B> איוליט (סוג אבן טובה).
Iphigenia	<B>(ש"ע)</B> איפיגניה.
Iris	<B>(ש"ע) </B>אלת הקשת היוונית.<BR><B>(ש"ע)</B> אירוס.
Ishtar	<B>(ש"ע)</B> אישתר. אלת האהבה והמיניות האכדית.
Isis	<B>(ש"ע)</B> איזיס. אלת האמהות, הפריון וכוכב נוגה המצרית.
Jack in the Green|Green Man	<B>(ש"ע)</B> ג'ק הירוק. אל היערות והעלווה הקלטי.
Janus|Ianus	<B>(ש"ע)</B> יאנוס. אל ראשית השנה הרומאי. בעל שתי פנים, האחד מביט אל השנה שנסתיימה והשני מביט אל השנה החדשה.
Jason	<B>(ש"ע)</B> יסון, יאסון, ג'ייסון.
Juno|Iuno	<B>(ש"ע)</B> יונו. אלת המלכות, ההגנה והסדר הציבורי הרומאית. אשת זאוס.
Jupiter|Iupiter	<B>(ש"ע)</B> יופיטר. האל הרומאי העליון. אל מזג האויר, הברקים, הרעמים, הגשמים, הבטחון והסדר הציבורי.<HR><B>(ש"ע) </B>יופיטר, צדק. כוכב לכת במערכת השמש.
Jupiter Ammon	<B>(ש"ע)</B> יופיטר אמון.
Jupiter Fulgur	<B>(ש"ע)</B> יופיטר פולגור. יופיטר מבריק הברקים. דמותו של יופיטר כאל הברקים הרומאי.
Jupiter Pluvius	<B>(ש"ע)</B> יופיטר פלוביוס. יופיטר מוריד הגשם. דמותו של יופיטר כאל הגשמים הרומאי.
Jupiter Tonans	<B>(ש"ע)</B> יופיטר טוננס. יופיטר הרועם. דמותו של יופיטר כאל הרעמים הרומאי.
Khemeia	<B>(ש"ע)</B> חמיה. בדת המצרית, מלאכת הפקת עפרה שחורה ממתכות. העפרה נחשבה לבעלת כוחות מאגיים וסימלה את גופו של אוסיריס בשאול. מן המונח הערבי אל-חמיה נולד המונח אלכימיה.
King Horn	<B>(ש"ע)</B> המלך הורן.
King Uther Pendragon|King Uther|Uther|Uther Pendragon	<B>(ש"פ)</B> המלך אתר פנדרגון. במיתולוגיה הקלטית ארתורית, אביו של המלך ארתור.
LBRP|Lesser Banishing Ritual of the Pentagram	טקס הגירוש הקטן של הפנטגרם. <BR>כשף גירוש ויקני נפוץ.
Lachesis	<B>(ש"ע)</B> לכזיס.
Lady Hobunde	<B>(ש"ע)</B> ליידי הובונד. גבירת השפע בפולקלור הצרפתי. מקורה בתקופת הכיבוש הרומאי בגליה והיא גלגול של אלת השגשוג הרומאית אבונדנטיה.
Laocoon	<B>(ש"ע)</B> לאוקון.
Lapithae	<B>(ש"ע)</B> לפיתים.
Lares	<B>(ש"ע)</B> לארס. אלילי בית ברליגיו רומנה.
Lares and Pentas	<B>(ש"ע)</B> לארס ופנטאס. אלילי הבית והשדה ברליגיו רומנה.<HR><B>(ש"ע) </B>מטאפורית: חפצי הבית היקרים.
Law of Thelema	<B>(ש"ע)</B> חוק תלמה. חוק שניסח המכשף אליסטייר קראולי: 'עשה ככל שתרצה, הוא התורה כולה'.
Left Hand Path|left-hand-path	<B>(ש"ע)</B> הנתיב השמאלי. מונח המתאר כשפים מרושעים ומזיקים.
Leo	<B>(ש"ע)</B> אריה, מזל אריה, בית אריה.
Litha	ליתה. כינוי להיפוך הקיץ, אחד משמונת חגי השמש בגלגל השנה הפגני. נחגג בתאריך 21 לדצמבר.
Lords of the Watchtowers|mighty ones|quarters|the mighty ones|the quarters|the watchers|the watchtowers|watchers|watchtowers	<B>(ש"ע)</B> אדוני מגדלי השמירה. רוחות שומרות בכל אחת מארבע רוחות השמים, המושלות כל אחת על יסוד מארבעת יסודות המאגיה.
Lorelei|Loreley	<B>(ש"ע)</B> לורליי.
Low Magic	<B>(ש"ע)</B> מאגיה נמוכה. כינוי לשיטות מאגיות שונות, שעיקרן עבודה עם חומרים ארציים כגון צמחים, אבנים, מים ואש.
Lucina	<B>(ש"ע)</B> לוסינה, לוצינה.
Lugh	<B>(ש"ע)</B> לו.
Lughnasadh|Festival of Lugh|Lunasa	<B>(ש"ע)</B> לונאסה, חג לו, חג התמוז. אחד משמונת חגי השמש בגלגל השנה הפגני. נחגג בתאריך 1 באוגוסט.
Luna	<B>(ש"ע)</B> לונה.
Lupercalia	<B>(ש"ע)</B> לופרקליה, לופרקלין.
Lustrum	<B>(ש"ע)</B> לוסטרום. ברליגיו רומנה, טקס טהרה הנערך מדי חמש שנים.
Ma'at|maat	<B>(ש"ע)</B> מאת, מעת. אלת האמת, הצדק והמשפט המצרית.
Mabon	<B>(ש"ע)</B> מבון. שם לחג ההשתוות הסתוית, אחד משמונת חגי השמש בגלגל השנה הפגני. נחגג בתאריך 21 לספטמבר.
Macha	<B>(ש"ע)</B> מאכה.
Maenad	<B>(ש"ע)</B> מנדה.
Maia|maya	<B>(ש"ע)</B> מאיה. במיתולוגיה היוונית, נימפה שהיתה בתו של אטלס ואמו של הרמס.
Malandanti	<B>(ש"ע)</B> בפולקלור האיטלקי, מכשפים רעים.
Mammon	<B>(ש"ע)</B> ממון, אל הכסף וההון.
Maponos|mabon	<B>(ש"ע)</B> מפונוס, מבון. אל השמש הקלטי ופטרון בריטניה.
March	<B>(ש"ע)</B> מרץ. החודש הראשון בלוח השנה הרומאי. החודש השלישי.
Marduk	<B>(ש"ע)</B> מרודך. האל העליון של הבבלים.
Mari Morgan|Morgan|Morgana|Morganes	<B>(ש"ע)</B> מארי מורגן. בת ים השוכנת לחוף ברייטון באנגליה ומפתה מלחים.
Mars	<B>(ש"ע)</B> מרס. אל המלחמה הרומאי. במקורו אל אדמה וצמיחה.<HR><B>(ש"ע)</B> באלכימיה: ברזל.
May Pole	<B>(ש"ע)</B> תורן מאי.
May Queen|Queen of May	<B>(ש"ע) </B>מלכת מאי, נערת חגיגות מאי, נערת מאי.
Maytide|Maytime	תקופת מאי
Medea	<B>(ש"ע)</B> מדיאה. במיתולוגיה היוונית, מכשפה וכהנת לאלה הקטה שסייעה ליסון להשיג את גיזת הזהב של אביה.
Melpomne	<B>(ש"ע)</B> מלפומנה.
Menelaus	<B>(ש"ע)</B> מנלאוס. מלך טרויה, אחי אגממנון ובעלה של הלנה היפה.
Mercury	<B>(ש"ע)</B> מרקורי, מרסוליס, מרקוריוס. אל רומאי.<HR><B>(ש"ע)</B> מרקורי. כוכב לכת במערכת השמש.
Merlin	<B>(ש"ע)</B> מרלין. מכשף במיתולוגיה הארתורית.<HR><B>(ש"ע)</B> כינוי למכשף.
Midas	<B>(ש"ע)</B> מידאס. במיתולוגיה היוונית, מלך שביקש מדיוניסוס שכל אשר יגע בו יהפוך לזהב. לאחר שגם מאכל ומשקה הפכו בידיו לזהב, ביקש מדיוניסוס שיקח בחזרה את מתנתו.
Midsummer	<B>(ש"ע)</B> היפוך הקיץ. אחד משמונת חגי השמש בגלגל השנה הפגני. נחגג בתאריך 21 ליוני.
Midwinter	<B>(ש"ע)</B> אמצע החורף, היפוך החורף. אחד משמונת חגי השמש בגלגל השנה הפגני. נחגג בתאריך 21 לדצמבר.
Mimir	<B>(ש"ע)</B> מימיר.
Minerva	<B>(ש"ע)</B> מינרווה, מינרבה. אלת האומנויות, הגילדות, הסוחרים והגלגל הרומאית.
Minos	<B>(ש"ע)</B> מינוס.
Mnyemosyne	<B>(ש"ע)</B> מנמוסינה.
Moabite Stone	<B>(ש"ע)</B> מצבת מישע. אבן חרוטה של מישע מלך מואב. נמצאת היום במוזיאון הלובר בפריז.
Moera|Moira	<B>(ש"ע)</B> מוירה.
Moloch|Molech	<B>(ש"ע)</B> מולך. אל פניקי, שהוקרבו לו ילדים.
Mom and Dad	אבא ואמא. בויקה בריטית מסורתית: כינוי של קרבה פרטית ורוחנית לאל ולאלה.
Morgan le Fay	<B>(ש"ע)</B> מורגן לה פיי. במיתולוגיה הארתורית, מכשפה מגזע הפיות ואחותו למחצה של המלך ארתור.
Morpheus	<B>(ש"ע)</B> מורפאוס.
Mut|mavet|mot	<B>(ש"ע)</B> מות. אל המוות הפניקי והכנעני.
Myrddin	<B>(ש"ע)</B> מירדין. שמו הקלטי המקורי של המכשף מרלין מן האגדות הארתוריות.
Myrmiddon	<B>(ש"ע)</B> מירמידון.
Nana	<B>(ש"ע)</B> ננה. אל הירח השומרי.
Narcissus	<B>(ש"פ)</B> נרקיס, נרקיסוס. במיתולוגיה היוונית, עלם יפה שהתאהב בבבואתו באגם והפך לפרח הנרקיס.<HR><B>(ש"ע)</B> נרקיס (פרח).<BR><BR><BR><BR><BR>
Neda	<B>(ש"פ)</B> נדה. במיתולוגיה היוונית, נימפה שטיפלה בזאוס התינוק כשהיה על ריאה אמו להחביאו מכרונוס אביו שרצה להרגו. היא הסתירה את זאוס בעריסה שתלתה על עץ.
Nemea	<B>(ש"ע)</B> נמיאה.
Neptune	<B>(ש"ע)</B> נפטון. אל הים והסוסים הרומאי.
Nereus	<B>(ש"ע)</B> נראוס. אבי הנראידות.
Nergal	<B>(ש"ע)</B> נרגל. אל המלחמה, המחלות והמגפה השומרי, בן זוגה של אלת המוות ארשקיגל.
Nerthus	<B>(ש"פ)</B> נרתוס. אלה אם אנגלו סקסונית. במקורה אלת פריון ומלכת הקציר. חוקרים מסוימים סוברים כי היא גירסה מקומית של אלת הפריון הגדולה פרייה.
Nessus	<B>(ש"ע)</B> נסוס.
Nestor	<B>(ש"ע)</B> נסטור.
Nibelungenlied	<B>(ש"ע)</B> שירת הניבלונגים, שיר הניבלונגים.
Nike	<B>(ש"ע)</B> ניקה, נייק.
Nimu	<B>(ש"ע)</B> נימו. גבירת האגם במיתולוגיה הארתורית.
Nine Noble Virtues|The Nine Noble Virtues|The Nine Noble Virtues of Asatru	<B>(ש"ע)</B> תשע המעלות האציליות. באסטרו ובדתות הגרמאניות, תשע תכונות שעל כל חבר בקהילה לשאוף ליישם אותן בחיי היומיום: כבוד, אמת, אומץ לב, התמדה, שמירת אמונים, משמעת, הכנסת אורחים, חריצות והיסמכות עצמית.
Ninus	<B>(ש"ע)</B> נינוס. מיסד העיר נינוה.
Niobe	<B>(ש"ע)</B> ניאובה.
Norse	<B>(ש"ע)</B> נורבגי, צפוני, סקנדינבי, השפה הנורבגית.
Nostardamus	<B>(ש"ע)</B> נוסטרדמוס.<HR><B>(ש"ע) </B>כינוי לחוזה עתידות.
Nox	<B>(ש"ע)</B> נוקס.
Oak King	<B>(ש"ע) </B>מלך אלון.
Oberon	<B>(ש"ע)</B> אוברון.
Occult Police	<B>(ש"ע)</B> משטרת תורת הנסתר. כינוי לאגודות בבריטניה העוסקות בשיטור אסטרלי ובאכיפת אתיקה מאגית.
Oceanus	<B>(ש"ע)</B> אוקיינוס.
October	<B>(ש"ע)</B> אוקטובר. החודש השמיני הרומאי. החודש העשירי.
Ocypete	<B>(ש"פ)</B> אוקיפטי. אחת משלוש ההרפיות, "השודדות", מפלצות מכונפות בעלות פני אשה זקנה וטפרים חדים ומעוקלים. ההרפיות הן שליחות האלים להענשת בני אדם. הן מענות אותם וגוררות אותם לשאול. אוקיפטי היא "מהירת כנף".
Odin	<B>(ש"ע)</B> אודין.
Odysseus	<B>(ש"ע)</B> אודיסאוס.
Odyssey	<B>(ש"ע)</B> אודיסיאה, אודיסיה.
Oedipus|Edipus	<B>(ש"ע)</B> אדיפוס.
Old Religion	<B>(ש"ע)</B> הדת הישנה. מונח כללי המתאר דתות פגניות טרום מונותיאיסטיות.
Olympus	<B>(ש"ע)</B> אולימפוס.
Ops	<B>(ש"ע)</B> אופס.
Orcus	<B>(ש"פ)</B> אורקוס.
Oread	<B>(ש"פ)</B> אוראדה, אוריאדה.
Orestes	<B>(ש"פ)</B> אורסטס.
Orion	<B>(ש"פ)</B> אוריון.
Orpheus	<B>(ש"פ)</B> אורפאוס.
Osiris	<B>(ש"פ)</B> אוסיריס. אל המוות והמתים המצרי.
Osiris position	<B>(ש"ע)</B> שליבת אוסיריס, תנוחת אוסיריס.
Ovid	<B>(ש"ע)</B> אובידיוס.
Paean|pean	<B>(ש"ע)</B> פיין. המנון לאל השמש היווני אפולו.
Pagan Standard Time|PST	<B>(ש"ע)</B> זמן הפגנים. מונח סלנג פגני, המתאר אירוע דתי או מאגי שלא מתחיל בזמן המיועד.
Pallas	<B>(ש"ע)</B> פלס. דמות האלה היוונית אתנה כאלת חוכמה.
Pan	<B>(ש"ע)</B> פן, פאן. אל הרועים והעדרים היווני.
Pandarus	<B>(ש"ע)</B> פנדרוס.
Pandora	<B>(ש"ע)</B> פנדורה.
Pantheon	<B>(ש"ע)</B> פנתאון. ארמון לאלים רבים באתונה העתיקה. בהשאלה: מכלול האלים בתרבות מסוימת.
Paris	<B>(ש"ע)</B> פריס.
Parnassus	<B>(ש"ע)</B> פרנסוס. הר בדרום יוון, מקודש לאפולו ולמוזות.
Parthenon	<B>(ש"ע)</B> פרתנון.
Parthenope	<B>(ש"ע)</B> פרתנופה.
Pax	<B>(ש"ע)</B> פקס. אלת השלום הרומאית.
Pecti Wita|Pecti-Wita|Wita	<B>(ש"ע)</B> פקטי ויטה. מסורת ויקה סקוטית.
Pegasus	<B>(ש"ע)</B> פגסוס. במיתולוגיה היוונית, סוס פלאי מכונף.
Pelops	<B>(ש"ע)</B> פלופס. בן טנטלוס במיתולוגיה היוונית.
Penelope	<B>(ש"ע)</B> פנלופי, פנלופה.
Perseid	<B>(ש"ע)</B> פרסאיד. בת פרסאוס במיתולוגיה היוונית.
Persephone	<B>(ש"ע)</B> אלת התבואה, הצמיחה ועונות השנה היוונית, בת דמטר, אלת האדמה. היא מבלה מחצית השנה אצל האדס בשאול ומחציתה האחרת עם אמה דמטר על פני האדמה. מעברי העונות מסמנים את הליכתה וביאתה.
Perseus	<B>(ש"ע)</B> פרסאוס. בנו של זאוס במיתולוגיה היוונית.
Phaedra	<B>(ש"ע)</B> פדרה.
Phaeton	<B>(ש"ע)</B> פאטון.
Pharaoh	<B>(ש"ע)</B> פרעה.
Philemon	<B>(ש"ע)</B> פילמון.
Philomena	<B>(ש"ע)</B> פילומנה.
Phoebe	<B>(ש"פ)</B> פיבי, פבה, כינוי לאלת הירח היוונית ארטמיס, ירח, לבנה.
Phoebus	<B>(ש"פ)</B> פיבוס, אפולו, שמש.
Phoenicia	<B>(ש"ע)</B> פניקיה.
Phrygia	<B>(ש"ע)</B> פריגיה.
Pirithous	<B>(ש"ע)</B> פיריתואוס.
Pisces	<B>(ש"ע)</B> דגים, מזל דגים, בית דגים.
Pleiades	<B>(ש"ע)</B> פלידות, פליאדות.
Pluto	<B>(ש"ע)</B> פלוטו, פלוטון. אל השאול הרומאי.<HR><B>(ש"ע) </B>כוכב פלוטו.
Polyhymnia	<B>(ש"ע) </B>פוליהימניה. מוזת שירת הקודש היוונית.
Pomona	<B>(ש"ע)</B> פומונה.
Poseidon	<B>(ש"ע)</B> פוסידון. אל הים והסוסים היווני.
Priam	<B>(ש"ע)</B> פריאם.
Priapus	<B>(ש"ע)</B> פריאפוס.
Procne	<B>(ש"ע)</B> פרוקנה.
Procrustes	<B>(ש"ע)</B> פרוקרוסטס.
Procrutean bed	<B>(ש"ע)</B> מיטת פרוקרוסטס.
Prometheus	<B>(ש"ע)</B> פרומתאוס.
Proserpina|Proserpine	<B>(ש"ע)</B> פרוסרפינה. אלת השאול הרומאית, אשתו של פלוטו.
Ptah	<B>(ש"ע)</B> פתח. אל מצרי.
Ptolmey	<B>(ש"ע)</B> תלמי.
Pygmallion	<B>(ש"ע)</B> פיגמליון.
Pyramus and Tuisbe	<B>(ש"ע)</B> פירמוס ותסבי.
Pyrrha	<B>(ש"ע)</B> פירהה.
Python	<B>(ש"ע)</B> פיתון.
Queen Mab	<B>(ש"ע)</B> המלכה מב. מלכת הפיות הממונה על החלומות.
Quirinus	<B>(ש"ע)</B> קווירינוס.
Ra|Re	<B>(ש"ע)</B> רע, רה, רא. אל השמש המצרי.
Ran	<B>(ש"ע)</B> רן. אלת הים הנורווגית.
Religio Romana	<B>(ש"ע)</B> רליגיו רומנה. הדת הרומאית.
Remus	<B>(ש"ע)</B> רמוס. אחד משני בני מרס שהושלכו לנהר הטיבריוס, ניצלו על ידי יניקה מחלב זאבה, ולימים יסדו את העיר רומא. אחיו הוא רמולוס.<BR>
Rhadamanthus	<B>(ש"ע)</B> רדמנתיס.
Rhea	<B>(ש"ע)</B> ראה, ריאה.
Rhea Silvia	<B>(ש"ע)</B> ריאה סילביה.
Rheda|Hred	<B>(ש"פ)</B> רדה. אחת מן הולקיריות במיתולוגיה הגרמאנית ואלת חורף.
Rheingold|Rheingeld	<B>(ש"ע)</B> זהב הריין. במיתולוגיה הגרמאנית אוצר מנהר הריין שהיה אצל הניבלונגים ואחר כך זכה בו זיגפריד.
Right Hand Path|right-hand-path	<B>(ש"ע)</B> הנתיב הימני. מונח המתאר כשפים מועילים וטובים.
Romulus	<B>(ש"ע)</B> רומולוס. אחד משני בני מרס שהושלכו לנהר הטיבריוס, ניצלו על ידי יניקה מחלב זאבה, ולימים יסדו את העיר רומא. אחיו הוא רמוס.
Rosicrucian	<B>(ש"ע) </B>רוזנקרויצר, חבר מסדר ורד הצלב.
Rosicrucianism	<B>(ש"ע)</B> רוזנקרויציות, מסדר ורד הצלב.
Sagittarius	<B>(ש"ע)</B> קשת, מזל קשת, בית קשת.
Sagittary	<B>(ש"פ)</B> קנטאור.
Saint-John's Wort|saint john's wort	<B>(ש"ע)</B> פרע.<BR>נקרא גם דם זכריהו הנביא, חומתי, רעם הנהר. בפולקלור ובמאגיה: צמח טיהור וגירוש, צמח הגדת עתידות וצמח אהבה ונישואין. אחד מן הצמחים המקודשים של ליל היפוך הקיץ. שמו הלטיני Hyepricum perforatum.
Saturn	<B>(ש"פ)</B> סטורן. אל הקציר הרומאי.<HR><B>(ש"פ) </B>סטורן, שבתאי. כוכב לכת במערכת השמש.
Saturnalia	<B>(ש"ע)</B> סטורנליה. החגיגה השנתית לאל סטורן ברומא העתיקה.
Satyr	<B>(ש"ע)</B> סטיר.
Scorpio	<B>(ש"ע)</B> עקרב, מזל עקרב, בית עקרב.
Seax Wicca	<B>(ש"ע)</B> סאקס ויקה, ויקה סקסונית. מסורת ויקה שפותחה על ידי המכשף הגרדנריאני ריימונד באקלנד.
Selene	<B>(ש"ע)</B> סלין. אלת הירח היוונית.
Semele	<B>(ש"ע)</B> סמלי, סמלה.
Seven Sleepers	<B>(ש"ע)</B> שבעת הישנים.
Shamash|Shapash|Shemesh|Shepesh	<B>(ש"ע)</B> שמש. אל השמש השומרי. בנם של ננה ונינגל.
Sibylline Books|Sibylline Oracles	<B>(ש"ע)</B> ספרי הסיבילות.
Sidhe	<B>(ש"ע)</B> שי. מונח גלי המתאר את מכלול הפיות במיתולוגיה הקלטית.
Siegfried	<B>(ש"ע)</B> זיגפריד. גיבור במיתולוגיה הגרמאנית.
Silvanus	<B>(ש"ע)</B> סילבנוס.<BR>
Silver Age	<B>(ש"ע)</B> תקופת הכסף.
Sisyphus	<B>(ש"ע)</B> סיזיפוס.
So Mote It Be	כך יהיה, אמן כן יהי רצון. משפט הנאמר בטקסים מאגיים.
Strega	<B>(ש"ע)</B> סטרגה. כינוי למכשפות עממיות בדרום איטליה.
Styx	<B>(ש"ע)</B> סטיקס.
Talos	<B>(ש"פ)</B> טלוס.
Tammuz	<B>(ש"פ)</B> תמוז. אל הצמיחה השומרי, בן זוגה של אישתר.
Tanit	<B>(ש"ע)</B> תנית. אלת פריון פניקית.
Tannhauser	<B>(ש"ע)</B> טנהויזר.
Tara	<B>(ש"ע)</B> טארה.
Tarpeia	<B>(ש"ע)</B> טרפיאה.
Tartarus	<B>(ש"ע)</B> טרטרוס
Taurus	<B>(ש"ע)</B> שור, מזל שור, בית שור.
Tellus	<B>(ש"ע)</B> טלוס.
Terpsichore	<B>(ש"ע)</B> טרפסיכורה.
Teutates|Albiorix	<B>(ש"ע)</B> טויטטס. אל קלטי גולי. נקרא גם אלביוריקס, מלך העולם.
Thalia	<B>(ש"ע)</B> תליה, תליאה.
Thanatos	<B>(ש"ע)</B> תנטוס.
The Book of the Dead|Book of the Dead	<B>(ש"ע)</B> ספר המתים. כתב יד ממצרים העתיקה, בו מפורטים הטקסים המדוקדקים שיש לערוך לאדם לאחר מותו כדי שיזכה לחיי נצח ומתוארות האמונות הדתיות של המצרים.
The Charge|Charge of the Goddess	<B>(ש"ע)</B> המצווה, הציווי. בויקה, טקסט שקוראים במהלך טקס הורדת הירח.
The Chariot	<B>(ש"ע)</B> מרכבה (קלף בארקנה הראשית של קלפי הטארוט).
The Craft	<B>(ש"ע)</B> האומנות. כינוי לאומנות הכשפים ולכישוף.
The Dagda	<B>(ש"ע)</B> הדגדה.
The Emperor	<B>(ש"ע)</B> הקיסר. קלף בארקנה הראשית של קלפי הטארוט.
The Empress	<B>(ש"ע)</B> הקיסרית (קלף בארקנה הראשית של קלפי הטארוט).
The Great Rite	<B>(ש"ע)</B> קדש, הטקס הגדול. הגירסה הויקנית להירוס גאמוס, הנישואין הקדושים, קיום יחסי מין מקודשים על המזבח.
The House of Life	<B>(ש"ע)</B> בית החיים. סוג מקדש גדול במצרים העתיקה, אליו היו מגיעים בני העם הפשוט כדי לקבל עצות דתיות, מאגיות ורפואיות.
The Lovers	<B>(ש"ע)</B> הנאהבים. קלף בארקנה הראשית של קלפי הטארוט.
The Mighty Ones|Mighty Ones	<B>(ש"ע)</B> האדירים. כינוי לשומרי המגדלים.
The Morrigan	<B>(ש"ע)</B> המוריגן.
The Occult|Occult	<B>(ש"ע)</B> תורת הסוד, חכמת הנסתר.
Theban	<B>(ש"ת)</B> של נא אמון במצרים, של תבס.
Thebes	<B>(ש"ע)</B> תבס, נא אמון.
Thelema	<B>(ש"ע)</B> תלמה. דת חידוש פגנית נוצרית, שנוסדה על ידי המכשף האנגלי אליסטייר קראולי.
Themis	<B>(ש"ע)</B> תמיס.
Thersites	<B>(ש"ע)</B> תרסיטס.
Theseus	<B>(ש"ע)</B> תזאוס, תסאוס.
Thetis	<B>(ש"ע)</B> תטיס.
Thor	<B>(ש"ע)</B> תור.
Thunderer	<B>(ש"ע) </B>מרעים הרעם. כינוי לזאוס, כינוי ליופיטר.
Thyest	<B>(ש"ע)</B> תיאסט.
Tisiphone	<B>(ש"ע)</B> טיסיפונה.
Tityus	<B>(ש"ע)</B> טיטיוס.
Tree Calendar|Celtic Tree Calendar	<B>(ש"ע)</B> לוח העצים הקלטי. לוח שנה קלטי, המבוסס על הירח והמחולק ל-13 חודשים שכל אחד מהם נקרא על שם עץ קדוש אחר.
Trojan Horse	<B>(ש"ע)</B> סוס טרויאני.
Troth|Code of Troth|The Code of Troth|The Troth	<B>(ש"ע)</B> תרות'. "אמון". הקוד המוסרי, ההתנהגותי והחברתי של מאמיני האסטרו והדתות הגרמאניות והנורדיות.
Tyche	<B>(ש"ע)</B> טיכה.
Tyhoes	<B>(ש"ע)</B> טיפואס.
Tyhpon	<B>(ש"ע)</B> טיפון.
Tyr|Tir|Tiu	<B>(ש"ע)</B> טיר. אל המלחמה הגרמאני והסקנדינבי. כיוון שהשתתפות במלחמה נתפסה כמעשה של כבוד בתרבות הנורדית, הוא נחשב אל אחוות לוחמים, כבוד ואומץ לב.
Tyre	<B>(ש"ע)</B> צור (עיר).
Tyrian	<B>(ש"ת)</B> צורי, בן העיר צור.
Ulysses	<B>(ש"ע)</B> יוליסס.
Unholden|The Unholden	<B>(ש"ע)</B> אנהולן. במיתולוגיה הגרמאנית, אויביה של האלה פראו הולה.
Uranus	<B>(ש"ע)</B> אורנוס.
Valhalla	<B>(ש"ע)</B> ולהאלה. היכל האל הסקנדינבי אודין.
Vanir	<B>(ש"ע)</B> וניר.
Venus	<B>(ש"ע)</B> ונוס. אלת האביב והגנים הרומאית.<HR><B>(ש"ע) </B>ונוס, נוגה. כוכב לכת במערכת השמש.
Vertumnus	<B>(ש"ע)</B> ורטומנוס.
Vesta	<B>(ש"ע)</B> וסטה. אלת האש היוונית.
Victoria	<B>(ש"ע)</B> ויקטוריה.
Virgo	<B>(ש"ע)</B> בתולה, מזל בתולה, בית בתולה.
Visigoth	<B>(ש"ע)</B> ויזיגות, גותי מערבי.
Viviane	<B>(ש"ע)</B> ויויאן. גבירת האגם במיתולוגיה הארתורית.
Vulcan	<B>(ש"ע)</B> וולקן.
Walpurgisnacht|Walpurgis night	<B>(ש"ע) </B>ולפורגיסנאכט, ליל ולפורגיס. שמו הגרמאני של בלתיין, אחד משמונת חגי השמש בגלגל השנה הפגני. נחגג בתאריך 30 לאפריל.
Wiccan Rede|Rede|The Rede|The Wiccan Rede|The Witches Rede	<B>(ש"ע)</B> חוק המכשפות, החוק הויקני. חוק אתיקה ויקני על פיו אל למכשפה לפגוע בשום דבר במעשיה, כולל עצמה, אנשים אחרים, בעלי חיים, צמחים, דוממים ורעיונות. 'ואם לא יזיק לשום דבר, עשי כפי שתרצי'
Wild Hunt|The wild hunt|Wild Army|Wuotaanes her	<B>(ש"פ)</B> המצוד הפראי. <BR>תהלוכה קולנית ומרשימה של רוכבים עטויי מלבושים עתיקים הדוהרים בלילות ומונהגים על ידי גיבור או אל. המצוד הפראי הוא תופעה מיסטית המוכרת בכל רחבי אירופה. בפולקלור האנגלי זוהי פמליית הרנה הצייד, אל הפריון בעל הקרניים, הרודפת בלילות את יער ווינדזור. מסורות אנגליות אחרות מייחסות את המצוד הפראי לפמליית המלך ארתור או לפמליית המלך הרלה. בצרפת מנהיג המצוד הפראי הוא לה גרנד וונר, "הציד הגדול", כינוי לאל הרנה. במיתולוגיה הנורדית זהו מסע התהלוכה של נשמות הגיבורים המובלות לוולהאלה על ידי האלה הולה והאל אודין. מכונה גם "הצבא הפראי". בדרך כלל מסוכן ונחשב סימן רע להבחין במצוד הפראי. קיים מספר רב של שיקויי קסם ומרקחות כישוף שנועדו לרפא אדם שחזה במצוד הפראי מעיוורון ואף משגעון.
Witta	<B>(ש"ע)</B> ויטה. מסורת ויקה אירית.
Woden	<B>(ש"ע)</B> וודן.
Wotan	<B>(ש"ע)</B> ווטן.
Wren	<B>(ש"ע)</B> רֶן.
Ygerna	<B>(ש"ע)</B> איגרנה. אם המלך ארתור במיתולוגיה הארתורית.
Yggdrasil	<B>(ש"ע) </B>איגדרסיל. עץ העולם במיתולוגיה הסקנדינבית.
Ymir	<B>(ש"ע)</B> אימיר.
Yule|Geola	<B>(ש"ע)</B> יול. אחד משמונת חגי השמש בגלגל השנה הפגני. נחגג בהיפוך החורף בתאריך 21 לדצמבר.
Yule log	<B>(ש"ע)</B> קורת יול, גזע יול. גזע עץ בוער בחגיגת יול, אחד משמונת חגי השמש בגלגל השנה הפגני.
Zephyrus	<B>(ש"פ)</B> זפירוס.
Zeus	<B>(ש"פ)</B> זאוס. מלך האלים במיתולוגיה היוונית.
a bone of an ibis|bone of an ibis|ibis|ibis bone	<B>(ש"ע)</B> עצם עוף החול. כינוי מאגי לצמח אשחר.
abracadabra	<B>(ש"ע)</B> אברקדברה. מילת קסם שמקורה במאגיה הגבוהה של ימי הביניים.
absinth|absinthe	<B>(ש"ע) </B>לענה. סוג צמחים ממשפחת המורכבים. שמו הלטיני Artemisia absinthium. בפולקלור הרוסי קשורים לכישופי הגנה, אך גם לוילות המרושעות. המכשף אליסטייר קראולי מקשר את משפחת הלענה בין השאר עם הורוס, פן, מרס, פריאפוס ופרגמוס.
acacia	<B> (ש"ע)</B> שיטת היאור. <BR>שיטה. עץ מקודש במצרים העתיקה. על פי המיתולוגיה המצרית נולדו האלים תחת עץ השיטה. שמה הלטיני Acacia nilotica.
aconite|monkhood|wolfsbane	<B>(ש"ע) </B>אקוניטון, חונק הדב, חונק הזאב, ביש. צמח רעיל המשמש בשיקוי קסם מסוימים. שמו הלטיני Aconitum Nepellus.<BR>
adept	<B>(ש"ע)</B> בר סמכא. אדם מבין ובקי באומנות הכשפים, שניתן לסמוך על ידיעותיו ונסיונו.<HR><B>(ש"ע)</B> בר סמכא. אחת מן הדרגות הבינוניות במסדרים המאגיים המיסטיים.
aeromancy	<B>(ש"ע)</B> נחש כוכבים (שיטת הגדת עתידות).
affiliation	<B>(ש"ע)</B> השתייכות, אפיליאציה. קבוצות בעלי שורשים בויקה בריטית מסורתית, ממסורות שונות. ההשתייכות קובעת לאיזה קו מסורת שייך המאמין בתוך הויקה המסורתית.
affirmation	<B>(ש"ע)</B> הצהרה, מתן תוקף. פעולה מאגית שמטרתה להשפיע על הלך הרוח של המאמין ועל ידי כך, להשפיע על הסביבה החיצונית.
agate	<B>(ש"ע)</B> אגת, אכט, אכטיס, שבו. סוג אבן טובה, נקראת על שם הנהר אכטיס בסיציליה, שם נחצבה בעת העתיקה. בפולקלור ובמאגיה נחשבת לאבן של אומץ לב והגנה, ולכן חביבה על לוחמים בקרב.
agate botswana	<B>(ש"ע)</B> אגת בוטצוונה (סוג אבן טובה). בפולקלור ובמאגיה נחשבת לאבן הגנה.
agate tortella	<B>(ש"ע)</B> אגת טורטלה (סוג אבן טובה).
agrimony|cockleburr|sticklewort	<B>(ש"ע)</B> אבגר צהוב. צמח בר רעיל המשמש ברפואה ובמאגיה העממית. שמו הלטיני Agrimonia eupatoria.<HR><B>(ש"ע)</B> גדותן הביצות. צמח המשמש ברפואה ובמאגיה העממית. שמו הלטיני Eupatorium cannabinum.
air	<B>(ש"ע)</B> אויר. אחד מארבעת היסודות המאגיים בטבע.
air signs	<B>(ש"ע)</B> מזלות האויר. שם לשלושת הבתים האסטרולוגיים המקושרים ליסוד האויר: תאומים, מאזניים ודלי.
aisling	<B>(ש"ע)</B> אשלין. חלום נבואי באמונה העממית האירית, בדרך כלל החלום הוא אודות אשה זקנה וחכמה המעבירה מסרים מן העולם הבא.
aitu|atua	<B>(ש"ע)</B> אייטו. במיתולוגיה הפולינזית, שם קיבוצי לאלוהויות פטרוניות של כפרים ומשפחות. לעיתים הן מופיעות בצורת צמחים, פרחים או בעלי חיים. נקראו גם בשם אטואה.
aka	<B>(ש"ע)</B> אקה. במאגיה, חוט הכסף המקשר בין הגוף הפיזי לגוף האסטרלי.
akasha	<B>(ש"ע)</B> אקשה. היסוד החמישי במאגיה. מקורו בתרבות האמריקאית הילידית ופירוש האתר הרוחני.
alchemist	<B>(ש"ע)</B> אלכימאי. אדם העוסק בתורת האלכימיה, שיטה מאגית ופילוסופית מימי הביניים.
alchemy	<B>(ש"פ)</B> אלכימיה. שיטה מאגית ופילוסופית מימי הביניים שביקשה להביא להתחדשות האדם בשלוש דרכים: הפיכת מתכות בסיסיות לזהב; מציאת סם החיים, אליקסיר; ויצירת אדם מלאכותי, הומונקולוס.
alder	<B>(ש"ע) </B>אלמון, אלנוס. עץ ממשפחת האלוניים. עץ החודש הרביעי בלוח העצים הקלטי: 18 מרץ - 14 אפריל. על פי האמונה הנורדית, אמבלה האשה הראשונה נבראה מן העץ. העצה משמשת לקסמי אהבה. שמו הלטיני Alnus glutinosa.
alignment	<B>(ש"ע)</B> התיישרות. במאגיה, טכניקה של התאמה לתנודות האלוהיות ביקום.
allspice	<B>(ש"ע)</B> פלפל אנגלי. <BR>צמח המשמש ברפואה ובמאגיה העממית. שמו הלטיני Pimento officinalis.
almond	<B>(ש"ע)</B> שקד.<BR>שקד מצוי, שקדייה. עץ בעל חשיבות במאגיה העממית. פריחתו מבשרת את האביב והוא אחד מן הסמלים המרכזיים של חג העצים בארץ כנען. נחשב אפרודיזיאק, צמח תשוקה ופריון. בפולקלור, צמח המעורר תשוקת נשים, ולכן
aloe	<B>(ש"ע)</B> אלוי אמיתי. <BR>אלוורה. צמח רב שנתי ממשפחת השושניים המשמש ברפואה ובמאגיה העממית. בפולקלור המזרח תיכוני נחשב לצמח הגנה. שמו הלטיני Aloe Vera.
alphitomancy	<B>(ש"ע)</B> נחש קמח שעורים ודבלים. שיטת הגדת עתידות.
altar	<B>(ש"ע)</B> מזבח. במה מורמת המשמשת בטקסים פגניים שונים או ניצבת במקום קבוע בבית או בחצר.
althaea	<B>(ש"ע)</B> נטופית רפואית.<BR>אלתיאה. צמח ממשפחת החלמיתיים המשמש ברפואה ובמאגיה העממית. שמו הלטיני Althaea officinalis.<BR><HR><B>(ש"פ)</B> אלתיאה. אמו של מלגר. כשנולד ניבאו שלוש המוירות שיחיה עד שיישרף ענף שנשרף באח. אלתיאה הוציאה את הענף והחביאה אותו. כשהרג מלגר את שני אחיה, השליכה את הענף בחזרה לאש.<BR>
amazonite	<B>(ש"ע)</B> אמזוניט. סוג אבן טובה, שבפולקלור נחשבת לאבן הסינתזה. על פי האמונה העממית, תעניק לבעליה תקווה, חמלה ואמונה.<BR>
amber	<B>(ש"ע) </B>ענבר, אמבר, כיפת הירדן. שרף מאובן בצבע זהוב בעל תכונות חשמליות. בגלל תכונותיו החשמליות והמגנטיות נחשב בפולקלור ובמאגיה לקמע הגנה, מזל טוב והתעוררות רוחנית.
ambrosia	<B>(ש"ע) </B>אמברוזיה. מזון אלי האולימפוס במיתולוגיה היוונית.
amethyst	<B>(ש"ע)</B> אמתיסט, אחלמה (סוג אבן טובה). שמה הלועזי קשור למיתוס היווני אודות דיוניסוס, ארטמיס והבתולה הזכה אמתיסט. שמה העברי ניתן לה מפני שהיא אבן שינה וחלומות.
amulet	<B>(ש"ע)</B> קמע. חפץ שמטרתו המאגית היא להגן על בעליו.
anemone	<B>(ש"ע) </B>כלנית. פרח בר ממשפחת הנוריתיים המסמל את דם האל אדון בדת הפניקית ואדוניס בדת היוונית.
angel	<B>(ש"ע)</B> מלאך. רוח אלוהית בדתות הלא פגניות, בעיקר בדתות המונותיאיסטיות.
angelica|kex|masterwort	<B>(ש"ע)</B> אנג'ליקה, מלאכית. צמח המשמש ברפואה ובמאגיה העממית. מקודש לאלה הנורדית היימדל (המה) ולולקיריות. בנצרות מקודש למלאך הפנים מיכאל. שמו הלטיני Angelica archangelica.
angle water	<B>(ש"ע)</B> מי מלאכים. שיקוי אהבה מן המאה ה-18. מכיל מי ורדים, מי תפוז, מי הדס, מושק וענבר אפור.
anima	<B>(ש"ע)</B> נפש.
anise	<B>(ש"ע)</B> כמנון האניס.<BR>נקרא בלשון הדיבור גם אניס, אניסון, שבת, כמנון. צמח בושמי הידוע בתכונותיו כאפרודיזיאק. היוונים והרומאים האמינו כי לזרע האניס יש כוח מעורר אהבה. על פי אמונות פולקלוריסטיות מסוימות נחשב לצמח מגרש עין רעה. שמו הלטיני Pimpinella anisum.
ankh	<B>(ש"ע)</B> ענח. סמל החיים בדת המצרית העתיקה.
anoint	<B>(פ')</B> למשוח בשמן. משיחה בשמן היא פעולה המתבצעת בטקסי חניכה פגניים ומאגיים שונים.
anointing	<B>(ש"ע)</B> משיחה בשמן. פעולה המתבצעת בטקסי חניכה פגניים ומאגיים שונים ומסמלת את ברכת האלוהות.<BR>
anointing oil	<B>(ש"ע)</B> שמן משיחה. שמן צמחי (בדרך כלל שמן זית) מבושם או מעורב במיני צמחים, המשמש למשיחה בטקסים דתיים ומאגיים.<HR><B>(ש"ע)</B> שמן המשחה. שמן זית מעורב במיני בשמים ששימש למשיחת מלכים בתקופת המקרא.
antler	<B>(ש"ע) </B>קרן צבי. בדתות פגניות שונות, סמל לאל בעל הקרניים ולאלוהות הזכרית.
aphrodisiac	<B>(ש"פ)</B> אפרודיזיאק. ביוון העתיקה, החגיגה השנתית לכבוד אלת האהבה אפרודיטה.<HR><B>(ש"ע)</B> בפולקלור וברפואה העממית, צמח, סממן או חומר אחר המעורר את התשוקה המינית.
apparition	<B>(ש"ע)</B> חזיון, התגלות. במיסטיקה, הופעה חזותית של רוח מת או ישות אסטרלית.
apple	<B>(ש"ע) </B>תפוח. <BR>אחד הפירות ששמם נקשר במכשפות ובהגדת עתידות. אחד מן הפירות המסורתיים של חג יול, אחד משמונת החגים בגלגל השנה הויקני. מסמליה של אלת הנעורים הנצחיים הקלטית אידהון. מקודש לאלה הגרמאנית הולה, לאל הנורדי פריי ולאלות הנורדיות גרד ופריג. שמו הלטיני Pyrus malus.
apple of love	<B>(ש"ע)</B> תפוח האהבה, עגבניה. בפולקלור ובמאגיה: סמל אהבה ותשוקה.
aptet	<B>(ש"ע)</B> אפטט. בדת המצרית, חפץ מאגי. ברור מה טיבו המדויק של החפץ, אך ידוע כי הפרעונים ניסו להשיגו.
aquamarine	<B>(ש"ע) </B>אקוומרין, אקווה מרין, תרשיש, ירק כחלחל. <BR>סוג אבן טובה הקשורה לים, למים ולנבואה.
arcana	<B>(ש"ע)</B> ארקנה. אחת משתי הסדרות הראשיות של קלפי הטארוט.
archangel	<B>(ש"ע)</B> מלאך הפנים. הגירסה היודאו-נוצרית לשומרי המגדלים.
archetype	<B>(ש"ע)</B> ארכיטיפ. סמל דמיוני שניתן לראות באמצעות חלומות, הרהורים, מדיטציה ונבואה. על פי תורות מאגיות שונות, ניתן לעמוד על משמעויות נסתרות ולהבין טוב יותר את התת מודע ואת המישור האסטרלי באמצעות הארכיטיפים.
archimage	<B>(ש"ע)</B> רב-מג. כהן גדול בכת עובדי האש בפרס העתיקה.
ark	<B>(ש"ע)</B> תבה, ארון, ארון קודש.
artichoke	<B>(ש"ע)</B> ארטישוק, קנרס, חרשף. צמח אכיל ממשפחת המורכבים. ידוע בתכונותיו האפרודיזיות ולכן משמש בשיקויי אהבה ובתבשילים שמטרתם לעורר תשוקה. קתרין דה מדיצ'י היתה ידועה בחיבתה השערורייתית לארטישוקים.
arum	<B>(ש"ע)</B> לוף מנומר.<BR>קארדי בלשון יוצאי כורדיסטן. צמח ממשפחת הלופיים, בעל חשיבות פולקלוריסטית במזרח התיכון. שמו הלטיני Arum dioscoridis.
ash|ash tree|nion	<B>(ש"ע)</B> מילה. <BR>עץ ממשפחת הזיתיים. עץ החודש השלישי בלוח העצים הקלטי: 18 פברואר - 17 מרץ. על פי המיתולוגיה הנורדית, האדם הראשון נברא מעץ המילה, הוא עץהחיים, יגדרסיל. מקודש לאל הנורדי אודין ולאלה הגרמנית אוסטרה. סמל העץ הוא אחד מעשרים ושש הרונות, אותיות הכתב הנורדי המקודש. רון המילה מסמלת כוח עמידה בפני אויבים. שמו הלטיני של העץ Fraxinus excelsior.
asparagus	<B>(ש"ע)</B> אספרגוס. ירק הידוע בתכונותיו כאפרודיזיאק ולכן משמש בתבשילי אהבה ובשיקויי אהבה.
aspect	<B>(ש"ע)</B> פנים, התגלמות, אספקט.<BR>במיתולוגיות העולם, מונח המתאר את הרב צדדיות של האלוהות. לאלוהות יחידה יכולים להיות מספר פנים, שונים זה מזה ומשלימים זה את זה. למשל, קודש היא התגלמות של אלת המלחמה הכנענית ענת, כאלת מין קדוש.
aspecting	<B>(ש"ע)</B> הפגנת פנים, אספקטיה. טכניקת מאגיה הנפוצה באסיפות מכשפות ובמהלכה מנסה אחד המשתתפים (בדרך כלל הכהנת הגדולה) להפוך לאספקט של האלוהות. טקס "הורדת הירח" הויקני הוא הצורה הנפוצה ביותר של הפגנת פנים.
asperger	<B>(ש"ע)</B> מזלף. צרור עשבים טריים, ספוגים טל או מי מעיין, המשמש לזילוף ולטיהור בטקסים דתיים ומאגיים שונים.
asphodel	<B>(ש"ע)</B> עירית גדולה.<BR>צמח בעל חשיבות ברפואה ובמאגיה העממית. נקרא גם נץ החלב. שמו הלטיני Asphodelus ramosus.
astral	<B>(ש"ת)</B> אסטרלי, כוכבי, שייך למישור האסטרלי, רוחני, של המישור הרוחני.
astral body	<B>(ש"ע)</B> גוף אסטרלי. גוף של תנודות אנרגטיות רופפות המקביל לגוף הפיזי ומסוגל להתנתק ממנו במהלך השינה או באמצעות טכניקות של הטלה אסטרלית.
astral energy	<B>(ש"ע) </B>אנרגיה אסטרלית. <BR>מונח המתאר את המודעות, המחשבות, החלומות, האשליות וכל הפעילות המנטלית של האדם. לא מדובר באנרגיה על פי הגדרתה המדעית.
astral journey	<B>(ש"ע)</B> מסע אסטרלי. במאגיה, יציאת הגוף האסטרלי מן הגוף המוחשי לשיטוטים או למשימות במישור האסטרלי.
astral light	<B>(ש"ע)</B> אור אסטרלי. הילת אור פוספורי המקיף עצמים או יצורים חיים.
astral plane	<B>(ש"ע)</B> המישור האסטרלי, המישור הכוכבי. על פי תיאוריות מאגיות מסוימות, מישור מודעות המתקיים במקביל למישור המציאות הפיזי. במישור האסטרלי מתקיימת פעילות אסטרלית: קיום של סמלים, אלוהויות, גופי אנרגיה אסטרלית. רוב התיאוריות העוסקות במישור האסטרלי, גורסות כי המישור האסטרלי מחולק לרמות.
astral projection|astral travel	<B>(ש"ע)</B> הטלה אסטרלית. יציאת הגוף האסטרלי מן הגוף המוחשי והמציאות הפיזית לעבר המישור האסטרלי.
astral spirits	<B>(ש"ע)</B> רוחות כוכבים. על פי האמונה הבבלית הקדומה, בכוכבים שוכנות רוחות אלוהיות.
astrologer	<B>(ש"ע)</B> אסטרולוג, אצטגנין, חוזה בכוכבים.
astrology	<B>(ש"ע)</B> אסטרולוגיה, אצטגנינות, חכמת המזלות. <BR>תורה העוסקת בהשפעת מיקום הכוכבים בשמים על האירועים המתרחשים בחיי בני האדם.
athame|athalme|black handled knife|black hilted knife|black-handled knife|black-hilted knife|dagger|dirk|knife|scian	<B>(ש"ע)</B> אתמי. פגיון מכשפה. <BR>פגיון טקס, המשמש אחד מן הכלים החשובים ביותר של הויקנים. משמש לסימון גבולות המעגל, לקריאה ולזימון רוחות מסוימות. הפגיון מסמל בויקה את אלמנט האש וקשור לרוח הדרום (זאת בניגוד לרוב התורות המאגיות הגורסות כי הפגיון והחרב מסמלים את אלמנט האויר וקשורים לרוח המזרח).
attracting magic	<B>(ש"ע)</B> כשף משיכה. שיטת כשפים שבאמצעותה מועברת אנרגיה מאובייקט אחד למשנהו.
attune	<B>(פ')</B> לכוונן. במאגיה ובקסם, לפעול כדי להביא להרמוניה בין ישויות פסיכיות ואלוהיות שונות.
augur	<B>(פ')</B> לראות את העתיד במעוף הציפורים.<BR><B>(פ')</B> לנבא העתיד, לבשר בשורות.
augury	<B>(ש"ע)</B> אבגור. שיטה רומאית עתיקה לניבוי העתיד באמצעות צפייה במעוף הציפורים.<BR><B>(ש"ע) </B>סימן לבאות, אות, בשורה.
aura	<B>(ש"ע)</B> הילה, אאורה. שדה אנרגיה סביב הגוף החיה. להילה צבעים מובחנים, ולכל צבע משמעות ייחודית.
aura balancing	<B>(ש"ע)</B> איזון הילות. טכניקה לזיכוך ולטיהור ההילה.
automatic writing	<B>(ש"ע)</B> כתיבה אוטומטית. טכניקה לקבלת מסרים מן המתים או מרוחות המצויות במישור האסטרלי. אדם הנמצא בטראנס תקשור כותב אוטומטית מסרים המגיעים אליו מעולם הרוחות. רוב מקרי הכתיבה האוטומטית התגלו כתרמיות.
autumn equinox	<B>(ש"ע)</B> השתוות סתוית, שויון הסתיו, ראשית הסתיו. אחד משמונת חגי השמש בגלגל השנה הפגני, נחגג בתאריך 21 למרץ.
aventurine	<B>(ש"ע)</B> אבנטורין (סוג אבן טובה). בפולקלור ובמאגיה נחשבת לאבן רוגע ושלווה, המקלה על נדודי שינה. היא קשורה לראייה ונקראת "אבן פוקחת עיניים". האבנטורין מכונה "אבן המהמרים", כיוון שהיא נחשבת למושכת כסף ומזל.
avocado	<B>(ש"ע)</B> אבוקדו. צמח שפירותיו ידועים כמעוררי תשוקה (אפרודיזיאק).
axe	<B>(ש"ע)</B> גרזן. בדת המצרית העתיקה מסמל הגרזן את הכוח האלוהי. מקודש לאלת המלחמה הכנענית ענת, המתוארת בתבליטים רבים כאוחזת גרזן בידה.
azurite	<B>(ש"ע)</B> אזוריט, אזורית (סוג אבן טובה). הכוהנים המצרים השתמשו באבן כדי לחדד את הראייה הנסתרת. נחשבת לאבן המסייעת בחידוד החושים הפסיכיים ובהגדת עתידות.
bacchanalia	<B>(ש"ע) </B>בכחנליה, חג בכחוס.
bacchant	<B>(ש"ע)</B> כהן בכחוס.
bacchante	<B>(ש"ע)</B> כהנת בכחוס.
baldersbrow	<B>(ש"ע)</B> בבונג. אחד מתשעת הצמחים המרפאים של המיתולוגיה האנגלו סקסית. מקודש לאל הנורדי בלדר. שמו הלטיני Matricaria chamomilla.
ballarmine	<B>(ש"ע)</B> בלרמין. סוג של בקבוק מכשפות שהיה בשימוש באנגליה בין המאה ה-17 למאה ה-19. הבלרמין הוא בקבוק חרס או זכוכית, בעל גוף מעוגל וצוואר צר. על גוף הבקבוק צוירה דמות גבר מזוקן על פי דיוקנו של הקרדינל הקתולי רוברט בלרמין. תכולת הבקבוקים דומה לבקבוקי מכשפות אחרים ברחבי העולם: מסמרים, סיכות, שברי זכוכית ומתכת, להבי סכינים ולעיתים אף שתן, שיער וציפורניים.
balm	<B>(ש"ע)</B> מליסה רפואית. <BR>צמח המשמש ברפואה ובמאגיה העממית. שמו הלטיני Melissa officinalis. רבים טועים בינו לבין הצמח צרי הגלעד.
balm of Gilead|balm of gilead	<B>(ש"ע)</B> צרי הגלעד.<BR>נקרא גם צרי, אפרסמון. צמח בעל חשיבות פולקלוריסטית ראשונה במעלה במזרח התיכון. משמש ברפואה ובמאגיה העממית. סמל של האלה הכנענית ענת, שהשתמשה בו כבושם. שמו הלטיני Commiphora opobalsamum. אין להתבלבל בינו לבין המליסה הרפואית, ששמה האנגלי העממי דומה לשמו של צרי הגלעד.
balsam	<B>(ש"ע)</B> אפרסמון, צרי, בשם, נטף.
balsam fir	<B>(ש"ע)</B> עץ הצרי.
bane	<B>(ש"ע)</B> רעל.<HR><B>(ש"ע) </B>בהשאלה, משהו מרושע.<BR>
banish	<B>(פ')</B> לגרש (רוח, מעגל).
banishing	<B>(ש"ע)</B> גירוש. טקס סגירת המעגל ופיזור האנרגיות הפסיכיות שנבנו בתוכו. <HR><B>(ש"ע) </B>גירוש. הדחת אדם מאסיפת מכשפות או מן הויקה, אם ביצע עברה בלתי נסלחת (בדרך כלל מדובר בהפרת סוד או בהפרת חוקי האתיקה).<HR><B>(ש"ע) </B>גירוש. טקס ניטרול וסילוק של ישות רוחנית או פסיכית. <BR>
banishing magic	<B>(ש"ע)</B> כשף גירוש.
banshee	<B>(ש"ע)</B> בנשי. במיתולוגיה הקלטית, רוח המבשרת מוות ביללותיה.
banshie	<B>(ש"ע)</B> בנשי. במיתולוגיה הקלטית, רוח המבשרת מוות ביללותיה.<BR>
baphomet	<B>(ש"ע)</B> בפומט. פסל של אלוהות בצורת תיש מכונף בעל שדי אשה ורגליים מסוכלות, שלכאורה נעבד על ידי אבירי המקדש, הטמפלרים.
bard|bardoi	<B>(ש"ע)</B> בארד, ברד.<BR>אדם השייך למעמד הפייטנים והמשוררים הקלטיים. כיוון שהאמונה הקלטית אסרה על כתיבה דתית, הבארד היה אחראי על שימור הזכרון ההיסטורי, המסורתי והדתי של הקהילה. שירי הבארד נחשבו בעלי סגולות מאגיות והקלטים האמינו כי ביכולתם לקלל או לברך.
barley	<B>(ש"ע)</B> שעורה. אחד ממיני התבואה המקודשים בדתות האדמה הפגניות החדשות. סמל של אלת הפריון. מקודשת לביגוויר, משרתו הגיבור של האל הנורדי פריי.
basil|basil (sweet)|basil, sweet|sweet basil	<B>(ש"ע)</B> ריחן מצוי.<BR>נקרא גם בזיליקום. עשב ממשפחת המנתה, משמש במאגיה וברפואה העממית. נחשב למעורר תשוקה המינית ומעודד פריון. שמו הלטיני Ocymum basilium.
bathing	<B>(ש"ע)</B> טבילה.
bay|laurel	<B>(ש"ע)</B> ער אציל.<BR>נקרא גם דפנה, עץ דפנה. שיח המשמש במאגיה וברפואה העממית. בפולקלור נקשר שמו עם תהילת נצחון. במיתולוגיה היוונית דפנה היא בתו של אל הנהר פנאוס, שנמלטה מחיזוריו של אל השמש אפולו. אביה סייע לה במנוסתה והפך אותה לשיח הדפנה. לכן מקודש שיח הדפנה לאפולו.
bee	<B>(ש"ע)</B> דבורה. חרק מקודש בדת הקלטית.
beech	<B>(ש"ע)</B> אשור. עץ המשמש במאגיה וברפואה העממית. על פי האמונה העממית, מגן מפני נחשים וברקים. שמו הלטיני Fugus sylvatica.
beldam	<B>(ש"ע)</B> בלדאם, מכשפה זקנה, מרשעת זקנה.
bell	<B>(ש"ע)</B> פעמון. אחד מכלי המכשפה וסמל טוהר, רחם, פוריות נשית וכיפת השמים.
bell book and candle	<B>(ש"ע)</B> פעמון, ספר ונר. כינוי כללי לכלי המכשפה.
belladonna	<B>(ש"ע)</B> בלדונה.<BR>נקרא גם יפהפייה, ענבי רוש. צמח ארסי ממשפחת הסולניים, המשמש במאגיה וברפואה העממית. שמו הלטיני Atropa Belladonna.
bergamot	<B>(ש"ע)</B> ברגמוט. בפולקלור, סוג תפוז הנפוץ במרקחות ובשיקויים, בעיקר שיקויי אהבה. נקרא על שם עיר באיטליה. שמו הלטיני Citrus bergamia.
beryl	<B>(ש"ע)</B> בריל, שהם.
besom	<B>(ש"ע)</B> מטאטא. אחד מכלי המכשפה. משמש לטיהור ולטקסי פריון.<BR>
beta body	<B>(ש"ע)</B> גוף בטא. כינוי לגוף האסטרלי. גוף של תנודות אנרגטיות רופפות המקביל לגוף הפיזי ומסוגל להתנתק ממנו במהלך השינה או באמצעות טכניקות של הטלה אסטרלית.<BR>
betony	<B>(ש"ע)</B> בטוניקה רפואית.<BR>בפולקלור האנגלו סקסי צמח מרפא, מגן מפני חזיונות תעתועים וחלומות רעים ומסייע בעת לידה. שמו הרפואי <BR>Betonica officinalis.
bewitch	<B>(פ')</B> להכשיף.
bewitchment	<B>(ש"ע)</B> הכשפה.
bi-location	(<B>ש"ע)</B> דו מיקומיות. <BR>סוג של הטלה אסטרלית, שבו האדם מודע בעת ובעונה אחת גם למתרחש במישור האסטרלי וגם למתרחש במישור המציאות הפיזית.<BR><HR><B>(ש"ע)</B> דו מיקומיות.<BR>סוג של טכניקה מאגית, שבו האדם נמצא בכמה מקומות בעת ובעונה אחת.
bibliomancy	<B>(ש"ע)</B> נחש ספרים. שיטת הגדת עתידות.
bilberry	<B>(ש"ע)</B> אוכמנית.
bind	<B>(פ')</B> לכפות. לבצע כשף כפיתה.
binding	<B>(ש"ע)</B> כפיתה. הטלת כשף כפיתה כדי למנוע רוע.
binding magic	<B>(ש"ע)</B> כשף כפיתה.
birch	<B>(ש"ע)</B> תרזה לבנה. <BR>נקרא גם לבנה. עץ החודש הראשון בלוח העצים הקלטי: 24 דצמבר - 20 ינואר. מקודש לאלים הגרמאניים תונור והולה. בפולקלור של צפון אירופה, צמח המגן מפני עין הרע ומרפא שגעון. שמו הלטיני Betula alba.
birth path number	<B>(ש"ע)</B> מספר נתיב הלידה. בנומרולוגיה, מספר תאריך הלידה של האדם, המתקבל מצירוף מספרי יום הלידה, חודש הלידה ושנת הלידה.
birthstone	<B>(ש"ע)</B> אבן יום ההולדת, אבן לידה.
black letter day	<B>(ש"ע) </B>יום שחור. על פי האמונה העממית, יום ללא מזל.
black magic	<B>(ש"ע)</B> מאגיה שחורה, כשף שחור, כשפים שחורים.
black shuck|old shuck|shuck	<B>(ש"ע)</B> שאק שחור. במיתולוגיה הקלטית, רוח רעה ומבשרת מוות בדמות כלב רפאים גדול ושחור.
blackberry|bramble	<B>(ש"ע)</B> אוכמנית שחורה. צמח בעל גרגירים אכילים, בעל חשיבות בפולקלור ובמאגיה הצפון אירופית והאנגלו סקסית. שם לטיני: Rubus.
blackthorn	<B>(ש"ע)</B> אטד.
bladderwrack	<B>(ש"ע)</B> בלדרק. סוג עשב ים שלפוחיתי המשמש בכישופי הגנה. שמו הלטיני הוא Fucus verisculusus.
blast	<B>(פ')</B> להטיל קללת פריון.<BR><B>(ש"ע) </B>קללת פריון.
blasting	<B>(ש"ע) </B>הטלת קללת פריון.
bless	<B>(פ')</B> לברך.
blessing	<B>(ש"ע)</B> ברכה.
blindfold	<B>(ש"ת)</B> קשור-עיניים, בעיניים קשורות.
blood	<B>(ש"ע)</B> דם.
blood sacrifice	<B>(ש"ע)</B> זבח דם, קרבן חי.
bloodberry	<B>(ש"ע)</B> דמדמנית.
blooding	<B>(ש"ע)</B> שתיתת דם. <BR>טכניקת עינוי והוצאה להורג של מכשפות בימי הביניים. המכשפה נחתכה מסביב לאף והונחה לדמם למוות.
bloodstone	<B>(ש"ע)</B> אבן דם (סוג אבן טובה).
bloodwort	<B>(ש"ע)</B> חומעה.
blue lace agate	<B>(ש"ע)</B> בלו לייס אגת (סוג אבן טובה).
bluebell	<B>(ש"ע)</B> פעמונייה.
blueberry	<B>(ש"ע)</B> אוכמניה כחולה.
boar	<B>(ש"ע)</B> חזיר בר. בתרבות הנורדית, הגרמאנית והאנגלו סקסית, חיה המקודשת לאלת הפריון והכשפים פרייה. ראש חזיר צלוי הוא אחד מן המאכלים החגיגיים המסורתיים של יול בתרבויות אלו.
bogey	<B>(ש"ע)</B> בוגי. במיתולוגיה הגרמאנית, שם לרוח רעה.
boggart	<B>(ש"ע)</B> בוגרט (שם אחר לבוגי). רוח רעה במיתולוגיה הגרמאנית.
boleen|bolline|white handled knife|white-handled-knife	<B>(ש"ע)</B> בולין, מאכלת. אחד מכלי המכשפה, המשמש לחריטה מאגית ולחיתוך עשבי מרפא. על פי המסורת צריכה הקת שלו להיות לבנה.
bonfire	<B>(ש"ע)</B> מדורה.
book of shadows	<B>(ש"ע)</B> ספר הצללים. ספר טקסים וכשפים השייך למכשפה בודדה או לאסיפות מכשפות.
book of the dead|Book of the Dead	<B>(ש"ע)</B> ספר המתים (ספר מצרי עתיק).
brass	<B>(ש"ע)</B> פליז, נחושת קלל. בפולקלור ובמאגיה, מתכת יעילה לגירוש רוע ורשע ולהגנה.
brew	<B>(ש"ע)</B> בישול. בפולקלור ובמאגיה, תערובת של צמחים וסממנים שונים, שהורתחו בקדרה.<BR>
briony	<B>(ש"ע)</B> דלעת הנחש. צמח ממשפחת הדלועיים. משמש בשיקויי אהבה.
broom	<B>(ש"ע)</B> מטאטא. אחד מכלי המכשפה. משמש לטיהור, לגירוש ולטקסי פריון.<HR><B>(ש"ע)</B> רותם. שיח שענפיו משמשים בטקסי פריון. אחד מן הצמחים המסורתיים של ליל ולפורגיס. צמח הגנה.משמש גם להגדת עתידות. שמו הלטיני Cytisus scoparius.
broom closet	<B>(ש"ע)</B> ארון המטאטאים. מונח המתאר את מצבן של מכשפות שאינן חושפות את אמונותיהן ופולחניהן לסביבתן, מחשש לרדיפה ודעות קדומות.
broomstick	<B>(ש"ע)</B> מקל מטאטא. משמש לטקסי פריון ואחיזת ידיים (חתונה).
bryony	<B>(ש"ע)</B> דלעת הנחש. ירק גינה, אחד מסמלי חג המתים הקלטי סמהין (ליל כל הקדושים הנוצרי).
bucentaur	<B>(ש"ע)</B> בוקנטאור.
buckthorn	<B>(ש"ע)</B> אשחר. שני מינים של צמח המשמש במאגיה וברפואה העממית. שמותיהם הלטיניים: Rhamnus frangula ו-Rhamnus cathartica.
budrock	<B>(ש"ע)</B> דקורית.
bull	<B>(ש"ע)</B> שור, פר. התגלמות של אל הפריון במיתולוגיות רבות ברחבי העולם. במיתולוגיה הכנענית קשור לאל, ראש הפנתאון ומלך האלים.
bull's eye	<B>(ש"ע)</B> עין השור (סוג אבן טובה).
burdock	<B>(ש"ע)</B> דקורית. צמח המשמש במאגיה וברפואה העממית. שמו הלטיני Arcticum lappa.
burning times	<B>(ש"ע)</B> תקופת ציד המכשפות.
buttercup	<B>(ש"ע)</B> נורית.
caduceus	<B>(ש"ע)</B> קדוסאוס, מטה קסם.
cakes and ale	<B>(ש"ע)</B> עוגות ושיכר (טקס ויקני).
cakes and wine	<B>(ש"ע)</B> עוגות ויין (טקס ויקני).
calacite	<B>(ש"ע)</B> כלצית (סוג אבן טובה).
calends|calenda|kalends	<B>(ש"ע)</B> קלנדה, ראש חודש רומאי.
call	<B>(ש"ע)</B> קריאה.<BR><B>(פ')</B> לקרוא.
camellia	<B>(ש"ע)</B> קמליה.
cameo	<B>(ש"ע)</B> פיתוחי אבן טובה, קמע. <BR>שיבוץ אבן טובה שמטרתו להגן על בעליו.
camphor	<B>(ש"ע)</B> קמפור, קומפרי. צמח המשמש במאגיה וברפואה העממית. שמו הלטיני Cinnamonum camphora.
candle	<B>(ש"ע)</B> נר, מנורה. מכלי המכשפה. משמשים לטיהור ולשריפה.
candle holder	<B>(ש"ע)</B> פמוט, מנורה.
candle magic	<B>(ש"ע)</B> כשף נרות. שיטת כשפים המסתייעת בנרות ובאנרגיית האש. כוללת גם התייחסות לתורת הצבעים, למועדי הירח ולאסטרולוגיה.
candlestick	<B>(ש"ע)</B> פמוט, מנורה.
canopic jar|canopic	<B>(ש"ע)</B> כד קנופי. במצרים העתיקה שימשו הכדים הקנופיים לשימור איברים פנימיים שהוצאו מגופות המומיות. מכסי הכדים עשויים בדמות ראשי ארבעת בניו של הורוס וכל אחד מהם מכיל סוג מסוים של איברים. הלב והריאות נשמרו בכד טומנוטף.
cantrip	<B>(ש"ע)</B> כישופון. כישוף קטן ומהיר בעל השפעה מינימלית.
capitoline	<B>(ש"ע)</B> קפיטולינה, גבעת רומא, גבעת הקפיטול.
capricorn	<B>(ש"ע)</B> גדי, מזל גדי, בית גדי.
caraway	<B>(ש"ע)</B> קימל, כרויה. צמח שגרגיריו המיובשים כתבלין משמשים במאגיה וברפואה העממית. שמו הלטיני Carum carvi.
carbuncle	<B>(ש"ע)</B> ברקת, גחלית, כדכד (סוג אבן טובה).
cardamon	<B>(ש"ע)</B> קרדמון, הל. צמח שגרגיריו המיובשים כתבלין משמשים במאגיה וברפואה העממית. נחשב לתבלין של עושר ונישואין בפולקלור של המזרח התיכון. שמו הלטיני Elettaria cardamomum.
cardinal points	<B>(ש"ע)</B> ארבע רוחות השמים. ארבעת הכיוונים המשמשים במעגל ובמאגיה ומסומנים בארבעת היסודות.
carline	<B>(ש"ע)</B> מכשפה זקנה בסקוטלנד.
carnation	<B>(ש"ע)</B> ציפורן. <BR>נקרא גם קרפול. משפחת צמחים שפרחיה משמשים במאגיה וברפואה העממית. שמה הלטיני Dianthus.
carnelian	<B>(ש"ע)</B> קרנליאן, קרניאולין, קרניאול. סוג אבן טובה. אחת משלוש אבני החן הקדושות במצרים העתיקה (האחרות הן לפיס לזולי וטורקיז). המצרים השתמשו בה בין השאר כקמע להגנה על הלב.
carrot|Queen Anne's Lace	<B>(ש"ע)</B> גזר בר. שורש המשמש במאגיה וברפואה העממית, במיוחד הצפון אירופית. שם לטיני: Dacus carota.
cast	<B>(פ')</B> להטיל (כישוף, מעגל, קללה).
cast a horoscope	<B>(פ')</B> לשרטט הורוסקופ.
cat	<B>(ש"ע)</B> חתול. בפולקלור ובמאגיה, בעל חיים מלווה, רגיש למישור האסטרלי, החביב על מכשפות.
cat's eye	<B>(ש"ע)</B> עין החתול (סוג אבן טובה).
catharsis	<B>(ש"ע)</B> קתרזיס. במאגיה, שחרור כל האנרגיות הפסיכיות והמאגיות בשיא הטקס.
catnip	<B>(ש"ע)</B> נפית החתולים. צמח המשמש במאגיה וברפואה העממית. שמו הלטיני Nepeta cataria.
catopromancy	<B>(ש"ע)</B> נחש מראות (שיטת הגדת עתידות).
cauldron	<B>(ש"ע)</B> קדרה. מכלי המכשפה. מסמלת את יסוד המים, הרחם, הפוריות, הלידה והלידה מחדש, הנעורים הנצחיים והירח. משמשת לרקיחת שיקויים ותבשילים.
cedar	<B>(ש"ע)</B> ארז. עץ המקודש לאל הגשם הכנעני הגדול בעל וקשור לאל האומנויות הכנעני כושר וחסיס.
cedarwood	<B>(ש"ע)</B> שמן עץ ארז. בפולקלור וברפואה העממית, תמצית שמן המופקת מקליפת עץ הארז. היתה נפוצה במצרים העתיקה.
celestial body	<B>(ש"ע)</B> גרם שמים.
celestite	<B>(ש"ע)</B> סלסטית, סלסטיט, צלסטין (סוג אבן טובה).
celtic|keltic	<B>(ש"ת)</B> קלטי.
cense	<B>(פ')</B> לקטר, להעלות קטורת.
censer	<B>(ש"ע)</B> כלי קטורת, בזיך, מחתה. אחד מכלי המכשפה, מסמל את יסוד האויר, משמש לטיהור האויר, להתעוררות כוח פסיכי וככלי להנחת מנחה לאלים.
centaur	<B>(ש"ע)</B> קנטאור.
centering	<B>(ש"ע)</B> מרכוז.
cetel	<B>(ש"ע)</B> קטל. בתרבות הקלטית אירית, שיר של הבארד. בבריטני נקרא בשם ליי.
chalcedomany	<B>(ש"ע)</B> נחש כלי נחושת (שיטת הגדת עתידות).
chalcedony	<B>(ש"ע)</B> כלצדוני, כדכד (סוג אבן טובה).
chaldaic	<B>(ש"ת)</B> כשדי
chalice|cup	<B>(ש"ע)</B> גביע. מכלי המכשפה. מסמל את יסוד המים, הרחם, הירח, הפוריות, הנשיות, המחזוריות וההכנסה בסוד.
chamoline	<B>(ש"ע)</B> קחון אציל. אחד מתשעת הצמחים המרפאים של המיתולוגיה האנגלו סקסית. שמו הלטיני Anthemis nobilis<HR><B>(ש"ע)</B> בבונג. אחד מתשעת הצמחים המרפאים של המיתולוגיה האנגלו סקסית. מקודש לאל הנורדי בלדר. שמו הלטיני Matricaria chamomilla.
chamomile	<B>(ש"ע)</B> קמומיל גרמני.<BR>נקרא גם בבונג. צמח שעליו משמשים במאגיה וברפואה העממית. שמו הלטיני Chamomilla recutita.<BR><HR><B>(ש"ע)</B> בבונג. אחד מתשעת הצמחים המרפאים של המיתולוגיה האנגלו סקסית. מקודש לאל הנורדי בלדר. שמו הלטיני Matricaria chamomilla.<BR>
changeling	<B>(ש"ע)</B> ילד חילוף. במיתולוגיות אירופיות שונות, ילד שהניחו הפיות במקום ילד יפה יותר שגנבו.
channeling	<B>(ש"ע)</B> תקשור.
chant	<B>(ש"ע)</B> פזמון.<BR><B>(פ') </B>לפזם.
chanting	<B>(ש"ע)</B> פיזום.
chaos	<B>(ש"ע)</B> כאוס. במיתולוגיה היוונית, חומר ראשוני חסר צורה שממנו נברא העולם.
chaote	<B>(ש"ע)</B> כאוט. מכשף העוסק בכשף כאוס.
charge	<B>(פ')</B> לטעון. למלא אבן, עשב או חפץ בכוח פסיכי למטרה מאגית מסוימת.
charging	<B>(ש"ע)</B> טעינה. מילוי אבן, עשב או חפץ בכוח פסיכי למטרה מאגית מסוימת.
charm	<B>(ש"ע) </B>מלת קסם, מילות קסם.<BR><B>(ש"ע) </B>סמל מאגי או פורמולה מאגית.<BR><B>(ש"ע) </B>קמע חקוק (במילות קסם או בסמלים).
charm bag	<B>(ש"ע)</B> שקיק קסם.
cheiromancy	<B>(ש"ע)</B> נחש כף היד (שיטת הגדת עתידות, קשורה בקשר הדוק לקריאה בכף היד).
chervil	<B>(ש"ע)</B> תמכה (סוג צמח תבלין ומרפא).
chive	<B>(ש"ע)</B> בצלית, כרש הסוף (צמח ממשפחת הבצליים).
chives	<B>(ש"ע) </B>שום העגל.<BR>נקרא גם עירית בצלית, עירית. צמח ממשפחת הבצליים המשמש במאגיה וברפואה העממית כסם הגנה. שמו הלטיני Allium schoenoprasum.
chrysoberyl	<B>(ש"ע)</B> כריסובריל (סוג אבן טובה).
chrysolite	<B>(ש"ע)</B> כריסוליט (סוג אבן טובה).
chrysopal	<B>(ש"ע) </B>כריסאופל, כריסוליט לבן (סוג אבן טובה).
chrysoprase	<B>(ש"ע)</B> כריסופרס (סוג אבן טובה).
cinanmmon	<B>(ש"ע)</B> קינמון.<BR>צמח תבלין המשמש במאגיה וברפואה העממית. בפולקלור נחשב לצמח עושר ושגשוג. שמו הלטיני Cinnamomum zeylanicum.
cinquefoil|five leaf grass|five-leaf-grass	<B>(ש"ע)</B> חמשן זוחל.<BR>נקרא גם חמש עלה. צמח בעל עלים מחומשים, המשמש במאגיה וברפואה העממית. נחשב לצמח מביא מזל. שמו הלטיני Potentilla reptans.
circle of protection|protective circle	<B>(ש"ע)</B> מעגל הגנה. סוג מיוחד של מעגל כשפים, שלא מוטל למטרת טקס, אלא למטרה הגנה קבועה או זמנית.
citrine	<B>(ש"ע)</B> סיטרין (סוג אבן טובה).
citron	<B>(ש"ע)</B> אתרוג.
citrus	<B>(ש"ע)</B> אתרוג. פרי הדר המשמש במאגיה העממית כפרי אהבה. נחשב סמל של אלות הירח דיאנה וארדיה.
clairvoyance	<B>(ש"ע)</B> ראיית נסתרות.
cleansing	<B>(ש"ע)</B> היטהרות. תהליך טיהור הגוף קודם לטקס בטבילה באמבט, בדרך כלל עם מלח ים ועשבים.
closing ritual	<B>(ש"ע)</B> טקס הסיום.
clove	<B>(ש"ע)</B> ציפורן. צמח תבלין המשמש במאגיה וברפואה העממית. שמו הלטיני Eugenia caryphyllata.
clover|bloodwort|trifolium|trifolium alba|trifolium prastense	<B>(ש"ע)</B> תלתן. עשב בעל עלים משולשים המשמש במאגיה וברפואה העממית. נחשב למביא מזל ומגן מפני רוחות רעות, עין הרע וכשפים. משמש גם להגדת עתידות, להפקת קטורת ולחליטת תה.
coltsfoot	<B>(ש"ע)</B> פרפרה. צמח המשמש במאגיה וברפואה העממית. שמו הלטיני Tussilago farfara.
comfrey	<B>(ש"ע)</B> סינפיטון רפואי.<BR>נקרא גם קויה. צמח המשמש במאגיה וברפואה העממית. שמו הלטיני Symphytum officinale.
concoction	<B>(ש"ע)</B> מרקחה, מרקחת. בפולקלור, תערובת צמחים וחומרים מאגיים שונים, כשיקוי, כבסיס לקטורת או כתערובת בשמים.
cone of power	<B>(ש"ע)</B> חרוט הכוח. <BR>אנרגיה בצורת חרוט, המנותבת במהלך טקס מאגי קבוצתי מבסיס מעגל קסם לעבר מטרה מסוימת.<BR>
conjure	<B>(פ')</B> להשביע (מעגל, שד, אל, רוח).
conjurer	<B>(ש"ע)</B> משביע רוחות. במאגיה הטקסית, מכשף העוסק בזימון שדים ורוחות כדי להכפיפם למטרותיו.<HR><B>(ש"ע)</B> משביע רוחות. בכישוף העממי, אדם בעל ידע בפורמולות כישוף שמטרתן לגרש השפעות של מכשפות רעות, עין הרע, שדים, רוחות וכדומה.
consecrate	<B>(פ')</B> לקדש, להקדיש.
consecration	<B>(ש"ע)</B> קידוש.
constellation	<B>(ש"ע)</B> מערכת כוכבים, קבוצת כוכבים, מזל.
contagious magic	<B>(ש"ע)</B> כשף הדבקה.
copal	<B>(ש"ע)</B> קופל (סוג שרף מאובן).
copper	<B>(ש"ע)</B> נחושת.
coral	<B>(ש"ע)</B> אלמוג. שלד מאובן של יצורים ימיים, המשמש כחפץ חן. מקודש לאלה הכנענית ענת.
cord	<B>(ש"ע)</B> חבל, מיתר, פתיל, משיחה, חוט, שרוך. אחד מכלי המכשפה. משמש ליצירת כוח פסיכי ובכישופים שונים.
cord magic	<B>(ש"ע)</B> כשף פתילים, כשף חבלים.
coriander|cilantro	<B>(ש"ע)</B> גד השדה.<BR>נקרא גם כוסברה, כוסבר. צמח תבלין המשמש במאגיה וברפואה העממית. נחשב צמח אהבה, תשוקה, פריון ושגשוג. שמו הלטיני Coriandrum sativum.
corn	<B>(ש"ע)</B> תירס. דגן המסמל אדמה ופריון.
corn dolly	<B>(ש"ע)</B> בובת תבואה, אמא דגן, אמא תבואה. דמות קלועה אלומות, מסמלת פריון, אדמה וקציר. משמשת בטקסי קציר ופריון, במיוחד אופיינית לבלתיין, אחד משמונת חגי השמש בגלגל השנה הפגני.
cornu ammonis	<B>(ש"ע)</B> קרן אמון.
cornucopia	<B>(ש"ע)</B> קורנוקופיה, קרן השפע, קרן אמלתיאה.
corpse light	<B>(ש"ע)</B> זהר רפאים.
correspondence	<B>(ש"ע)</B> התאמה.
counterclockwise	<B>(ש"ע)</B> נגד כיוון השעון, נגד כיוון השמש, שמאלה.
couvade	<B>(ש"ע)</B> קובד (כישוף לידה צרפתי).
coven	<B>(ש"ע)</B> אסיפה, קהיליה, עדה, קוון (קבוצת מכשפות המקיימת פולחן ומטילה כשפים בצוותא).
covenstead	<B>(ש"ע)</B> תחום האסיפה, תחום הקהילייה. בויקה, המקום הקבוע בו נפגשת האסיפה לעבודתה הדתית והמאגית ושלושה מילין המקיפים אותו.
cow	<B>(ש"ע)</B> פרה. בפולקלור ובמאגיה, סמל פריון, הריון, הנקה ואמהות. במיתולוגיה הכנענית סמל של אלת הפריון הגדולה אשרה.
cowan	<B>(ש"ע)</B> עם הארץ. אדם שלא הוכנס בסוד אומנות הכשפים.
cowslip|Freya's key	<B>(ש"ע)</B> בכור אביב מצוי. צמח המשמש במאגיה וברפואה העממית. מקודש לאלה הנורדית פרייה ונחשב צמח אהבה, תשוקה ויופי. שמו הלטיני Primula veris.
crab	<B>(ש"ע)</B> מזל סרטן.
craft name|magical name|magickal name	<B>(ש"ע)</B> שם אומנות. שם חשאי שמקבלת המכשפה במעמד הכנסתה בסוד.
cranberry	<B>(ש"ע)</B> חמוצית.
creeping horror	<B>(ש"ע)</B> זוועה זוחלת (שד).
crone	<B>(ש"ע)</B> זקנה, בלה, סבתא חכמה. בדתות פגניות שונות, סמל לירח המתמעט, הפן השלישי של האלה והשלב האחרון במעגל החיים הנשי.
croning	<B>(ש"ע)</B> חכימא, קרונינג. טקס פגני, המציין את מעבר האשה לשלב הסבתא בחייה (בדרך כלל עם תחילת גיל המעבר).
cross	<B>(ש"ע)</B> צלב.
cross of confusion	<B>(ש"ע)</B> צלב הבלבול. סמל רומאי עתיק, המסמן את דחיית הנצרות.
cross quarter days	<B>(ש"ע)</B> ימי רבעי הצלב. מונח המתאר את ארבעת חגי האש מתוך שמונת חגי השמש בגלגל השנה הפגני: סו-ווין, איבולג, בלתיין ולונאסה. בתרבות הקלטית החגים הללו נחשבים לארבעת החגים הגדולים של השנה.
crossroad	<B>(ש"ע)</B> צומת דרכים, הצטלבות דרכים. במאגיה, אתר מסורתי לטקסים, פולחנים וכשפים. הצטלבויות הדרכים מקודשות לאלה התראקית הקטה.
crowd	<B>(ש"ע) </B>קראוד (סוג קתרוס קלטי).
crowl	<B>(ש"ע)</B> קראול (גמד באירלנד)
crux ansata	<B>(ש"ע) </B>ענח (סמל החיים המצרי).
crystal	<B>(ש"ע)</B> קריסטל, בדולח.
crystall ball	<B>(ש"ע)</B> כדור בדולח.
crystallomancy	<B>(ש"ע)</B> נחש כדור בדולח (שיטת הגדת עתידות).
cummer	<B>(ש"ע)</B> קאמר. מכשפה, מיילדת ומרפאה בסקוטלנד.
cunning man|cunning woman	<B>(ש"ע)</B> תחבולן. כינוי למכשף עממי באנגליה הכפרית.
cup	<B>(ש"ע)</B> כוס, גביע. מכלי המכשפה. מסמל את יסוד המים, הרחם, הירח, הפוריות, הנשיות, המחזוריות וההכנסה בסוד.
curse	<B>(ש"ע)</B> קללה.
cyclamen	<B>(ש"ע)</B> רקפת. פרח המשמש במאגיה וברפואה העממית. שמו הלטיני Cyclamen persicum. פריחתו האדומה מסמלת את דמו של האל הכנעני אדון.
cyclop	<B>(ש"ע)</B> קיקלופ. במיתולוגיה היוונית, מפלצת בעלת עין אחת.
cypress	<B>(ש"ע)</B> ברוש. עץ בעל חשיבות במאגיה וברפואה העממית. לעיתים מכונה תאשור.
daemon	<B>(ש"ע)</B> דיימון.
daemonology|demonology	<B>(ש"ע)</B> דמונולוגיה. בנצרות, תורת הקטלוג והאפיון של שדים.
daemonurgy|demonurgy	<B>(ש"ע) </B>דמונורגיה. תורת הכשף בעזרת רוחות.
daffodil	<B>(ש"ע)</B> נרקיס. צמח בעל חשיבות מיתולוגית. על פי האמונה ההלנית, נרקיס היה נער שהתאהב בבבואתו הנשקפת באגם. האלה אפרודיטה הפכה אותו לפרח הצומח על גדות ביצות ואגמים. שמו הלטיני Narcissus pseudo-narcissus.
daisy	<B>(ש"ע)</B> חיננית רב שנתית.<BR>פרח המשמש במאגיה וברפואה העממית. נחשב לפרח אהבה ומשמש להגדת עתידות אהבה. אחד מן הצמחים המסורתיים של היפוך הקיץ. מקודש לאלת השמש הנורדית סונה. שמו הלטיני Bellis perennis.
dandelion	<B>(ש"ע)</B> שנן רפואי.<BR>נקרא שן הארי בלשון הדיבור. צמח המשמש במאגיה וברפואה העממית. שמו הלטיני Taraxacum officinale.
datura|thornapple	<B>(ש"ע)</B> דטורה זקופת פרי.<BR>נקרא גם ברש, דתור. צמח רעיל המשמש במאגיה. שמו הלטיני Datura stamonium.
days of power	<B>(ש"ע)</B> ימים של כוח. מונח המתאר את הימים הקדושים הפגניים, הנחשבים לטובים במיוחד להטלת כשפים.
dedicant	<B>(ש"ע)</B> מתלמד. חבר באסיפת מכשפות או בדת בעלת מסורת סודית, טרם טקס החניכה הרשמי שלו.
dedication	<B>(ש"ע)</B> הקדשה. טקס של קבלת אומנות הכשפים ומחויבות לדרך שהיא מתווה בלימוד, באמונה ובפולחן.<BR>
defence	<B>(ש"ע)</B> התגוננות.
degree	<B>(ש"ע)</B> דרגה. רמת הניסיון והידע של חבר באספת מכשפות. קבלת דרגה מותנית בניסיונות ובמבחנים ונערכת בטקס הכנסה בסוד.
deity	<B>(ש"ע)</B> אלוהות.
demigod	<B>(ש"ע)</B> חצי אל.
demigoddess	<B>(ש"ע)</B> חצי אלה.
demon	<B>(ש"ע)</B> שד.
deosil	<B>(ש"ע)</B> ימינה, בכיוון השמש, בכיוון השעון, דאוסיל. במאגיה ובכישוף, תנועה ריטואלית בכיוון השמש.
deus	<B>(ש"ע)</B> אל, אלוהים.
devil's weed	<B>(ש"ע)</B> בלדונה. צמח ארסי ממשפחת הסולניים. שמו הלטיני Atropa Belladonna.<BR>
diamond	<B>(ש"ע)</B> יהלום (סוג אבן טובה).
dianic	<B>(ש"ת)</B> דיאני, של מסורת הויקה הדיאנית.
dill	<B>(ש"ע)</B> אחישבת, שמיר. צמח המשמש במאגיה וברפואה העממית. שמו הלטיני Peucedanum graveolens.
dittany de crete	<B>(ש"ע)</B> אזובית, אזובית כרתים.<BR>צמח המשמש במאגיה וברפואה העממית. שמו הלטיני Orignaum dictamus.
divination	<B>(ש"ע) </B>הגדת עתידות.
divining rod	<B>(ש"ע)</B> מטה נחש. מטה עשוי עץ ערבה או אלסר לגילוי מים ומחצבים.
djinn|genie|jinn	<B>(ש"ע)</B> ג'ין. שד ערבי.
do wonders	<B>(פ')</B> לחולל פלאים, לחולל נפלאות.
doctrine of signatures	<B>(ש"ע)</B> דוקטרינת החתימות. תיאוריה מאגית, לפיה לכל יצור חי ובמיוחד לצמחים, יש איכות ייחודית או תנודה פסיכית ייחודית.
dog star	<B>(ש"ע)</B> כוכב הכלב, אברק, סיריוס.
dogwood	<B>(ש"ע)</B> קרנית (צמח).
doorway	<B>(ש"ע)</B> פתח כניסת המעגל.
doppelganger	<B>(ש"ע)</B> במיתולוגיה הגרמאנית, רוח תאומה המלווה את האדם כצל.
double edged knife|double-edged knife	<B>(ש"ע)</B> סכין פיפיות, פגיון מכשפה. אחד מכלי המכשפה, משמש לסימון גבולות המעגל ולזימון רוחות מסוימות.<BR>
double edged sword|double-edged sword|two edged sword|two-edged sword	<B>(ש"ע)</B> חרב פיפיות. מכלי המכשפה. תפקידה דומה לתפקיד פגיון המכשפה.
dowsing	<B>(ש"ע)</B> גישוש. שיטה מאגית לאיתור אדם, חפץ או מקום או לקבלת תשובת כן או לא, באמצעות מטוטלת או מקל.
dracomancer	<B>(ש"ע)</B> דרקונאי. מכשף העוסק בכשף דרקונים.
draconites	<B>(ש"ע)</B> דרקוניטס. על פי האמונה העממית, אבן יקרה שנלקחה ממוח דרקון.
dragon|drake	<B>(ש"ע)</B> דרקון.
dragon tree	<B>(ש"ע)</B> הדרקונית הקנרית (עץ).
dragon's blood|dragon blood	<B>(ש"ע)</B> דם הדרקון, שרף הדרקונית הקנרית. שרף אדום המופק מעץ הדרקוני הקנרית. משמש במאגיה. שמו הלטיני של העץ הוא Daemomorops draco.
dreamtime	<B>(ש"ע)</B> עולם החלומות. מונח שמאני המתאר את העולם המקביל לעולם הפיזי.
dreamwatch	<B>(ש"ע)</B> חיפושית המוות.
druid	<B>(ש"ע)</B> דרואיד.
druid's altar	<B>(ש"ע)</B> דולמן, מזבח דרואידי.
druidry|druidism	<B>(ש"ע)</B> דרואידיות.
dwarf	<B>(ש"ע)</B> דוורף. יצור גמדי במיתולוגיה הסקנדינבית.
eagle	<B>(ש"ע)</B> נשר, עיט.
earth	<B>(ש"ע)</B> ארץ, אדמה. אחד מארבעת היסודות המאגיים בטבע.<BR>
earth magic	<B>(ש"ע)</B> כשף אדמה. שיטה מאגית המשתמשת באנרגיה הפסיכית של אמא אדמה ושל הארץ.
earth power	<B>(ש"ע)</B> כוח האדמה. מונח המתאר את הכוח המאגי או הכוח הפסיכי הקיים בכל מה שנובע מן האדמה, כגון עפר, אבנים, מים וצמחים. שיטות מאגיות שונות משתמשות בכוח האדמה כדי להטיל כשפים.
earthing|grounding	<B>(ש"ע)</B> קרקוע.
eclectic|eclectic wiccan|eclectic witch	<B>(ש"ע) </B>מכשפה אקלקטית. מכשפה שאינה דבקה במסורת ויקה מסוימת או בדת פגנית אחת אלא פולחנה ואמונותיה שאובים ממקורות שונים ומשלבים השראה אישית רבית.
egregore	<B>(ש"ע)</B> אגרגור. מחשבה קבוצתית, הלך רוח, אקלים חברתי ייחודי של קהיליית כישוף מסוימת.
elder|ellhorn|hylan tree	<B>(ש"ע)</B> סמבוק שחור. <BR>עץ החודש השלוש עשר בלוח העצים הקלטי: 25 נובמבר - 23 דצמבר. אחד מן העצים הקדושים ביותר בתרבות הגרמאנית. מקודש לליידי אלהורן (הילדה מור), דמות האלה הולה כגבירת העץ. על פי האמונה העממית הגרמאנית, יש לבקש ממנה רשות ולהניח לה מנחה לפני שכורתים עץ סמבוק. נחשב עץ הגנה. שמו הלטיני Sambucus nigra.<BR><HR><B>(ש"ע) </B>זקן העדה, זקנת העדה, חכימא, חכם.<BR>בדתות פגניות חדשות: מכשף או מכשפה בדרגות גבוהות, שמתייעצים עמם בענייני מדיניות, פולחן, משמעת ומאגיה.
element	<B>(ש"ע)</B> יסוד.
elemental	<B>(ש"ע)</B> רוח יסוד.
elf	<B>(ש"ע)</B> אלף, עלף. רוח טבע במיתולוגיה הסקנדינבית.
elf child|elven|elvenkind	<B>(ש"ע)</B> ילד עלפים. על פי האמונה העממית בסקדינביה, ילד שהניחו העלפים במקום ילד יפה יותר שגנבו.
elf fire	<B>(ש"ע)</B> אש עלפים, זוהר רפאים.
elfdock|Horse Heal|elecampane	<B>(ש"ע)</B> אינולה הדורה. בתרבות הצפון אירופית, צמח המקודש לאלפנקינד, גזע העלפים. נחשב צמח חוכמה וכשפים. משמש גם ברפואה העממית. שמו הלטיני: Inula helenium.<BR>
elfin	<B>(ש"ע)</B> אלפין, עלפין.
elfkin	<B>(ש"ע)</B> אלפקין, עלפקין.
elixir	<B>(ש"ע)</B> באלכימיה, אליקסיר, סם החיים.<HR><B>(ש"ע) </B>אליקסיר. במאגיה ובפולקלור, נוזל מוטען עם אבן טובה או קריסטל.
elm|elven	<B>(ש"ע)</B> בוקיצת השדות. עץ בעל חשיבות במאגיה וברפואה העממית. שמו הלטיני Ulmus. על פי אחת המסורות של המיתולוגיה הנורדית, נבראה האשה הראשונה אמבלה מעץ הבוקיצה. מקודש לאלים הנורדיים וודן, וולי
emerald	<B>(ש"ע)</B> אזמרגד, אמרלד, נפך (סוג אבן טובה).
empowerment	<B>(ש"ע)</B> העצמה. במאגיה, טכניקה של טעינה בכוח פסיכי אישי חזק.
enchant	<B>(פ') </B>להקסים.
enchantment	<B>(ש"ע)</B> הקסמה. טכניקת כישוף באמצעות מילות קסם. בדרך כלל מדובר בכישוף השתלטות או שעבוד לרצון המכשפה.
energy	<B>(ש"ע)</B> אנרגיה.
energy channeling	<B>(ש"ע)</B> תיעול אנרגיה.
energy directing	<B>(ש"ע)</B> ניתוב אנרגיה.
essential oil	<B>(ש"ע)</B> תמצית שמן. שמן שנסחט מצמחים, מקליפות עצים, מפירות או מפרחים. משמש ברפואה העממית וכן לטקסים דתיים ומאגיים.
etruscan	<B>(ש"ת)</B> אטרוסקי.
evening star	<B>(ש"ע)</B> כוכב הערב, ונוס, נוגה.
evil eye	<B>(ש"ע)</B> עין הרע, עין רעה, עינא בישא.
evil spirits	<B>(ש"ע)</B> רוחות רעות.
evocation	<B>(ש"ע)</B> זימון. קריאה לאלוהות או לישות אסטרלית לתוך מעגל או להשתתף בטקס מאגי או דתי.<BR>
evoke	<B>(פ')</B> לזמן. זימון היא קריאה לאלוהות או לישות אסטרלית לתוך מעגל או להשתתף בטקס מאגי או דתי.<BR><BR>
fae|fay	<B>(ש"ע)</B> הפיות, עולם הפיות.
faery	<B>(ש"ע)</B> פייה.
fairy	<B>(ש"ע)</B> פייה.
fairy light	<B>(ש"ע)</B> זהר רפאים.
fairy ring	<B>(ש"ע)</B> טבעת פיות, עיגול קסם.
fairydom	<B>(ש"ע)</B> עולם הפיות, ממלכת הפיות.
fairyism	<B>(ש"ע)</B> טבע הפיות, הווית הפיות, האמונה בפיות.
fairyland	<B>(ש"ע)</B> ארץ הפיות, ארץ הקסם.
falcon	<B>(ש"ע)</B> בז.
familiar	<B>(ש"ע)</B> חיה מלווה. בעל חיים שרוחו רגישה למישור האסטרלי ומסייע לבעליו בטקסים רוחניים.
fanstam|phantasm|phantasma	<B>(ש"ע)</B> פנטזם, חזיון תעתועים.
fascination	<B>(ש"ע)</B> הפעמה. במאגיה, שליטה מוחלטת במוחו של אדם.
fata morgana	<B>(ש"ע)</B> פטה מורגנה, הפיה מורגן.
fatal thread	<B>(ש"ע)</B> חוט הגורל, פתיל החיים.
fearn	<B>(ש"ע) </B>אלמון, אלנוס. עץ קסום ממשפחת האלוניים. עץ החודש הרביעי בלוח העצים הקלטי: 18 מרץ - 14 אפריל.
fennel	<B>(ש"ע)</B> שומר פשוט. צמח המשמש במאגיה וברפואה העממית שמו הלטיני Foeniculum vulgare.
fern	<B>(ש"ע)</B> שרך.
fest	<B>(ש"ע)</B> חגיגה, חג.
festival	<B>(ש"ע)</B> חגיגה, חג, פסטיבל.
fetch|summoner	<B>(ש"ע) </B>מזמנת. מכשפה שתפקידה להודיע לחברי האסיפה מתי והיכן מתקיימים הכינוסים, המועדים והחגיגות.<BR>
feverfew	<B>(ש"ע)</B> חרצית, בן חרצית. פרח בר המשמש במאגיה וברפואה העממית. שמו הלטיני Chrysantemum parthenium.
fig	<B>(ש"ע)</B> תאנה. עץ המזוהה עם אלת הפריון הכנענית הגדולה אשרה. ביהדות נחשב לאחד משבעת המינים שהתברכה בהם ארץ ישראל.
figure	<B>(ש"ע)</B> פסל.
figurine	<B>(ש"ע)</B> פסלון.
fir	<B>(ש"ע)</B> אשוח. אחד מן העצים המסורתיים של חג יול ושל מודרנכט. מסמל חיי נצח ואלמוות. בתרבות הגרמאנית עשו ממנו מזבחות. משמש גם במאגיה וברפואה העממית. שמו שלטיני Abies cilica.
fire	<B>(ש"ע)</B> אש. אחד מארבעת היסודות המאגיים בטבע.<BR>
fire agate	<B>(ש"ע) </B>אגת אש. סוג אבן טובה.
fire worship	<B>(ש"ע)</B> פולחן האש, עבודת אש.
firedrake	<B>(ש"ע)</B> דרקון האש. יצור פלאי במיתולוגיה הגרמאנית.
first degree initation	<B>(ש"ע)</B> הכנסה בסוד לדרגה ראשונה.
flagellation	<B>(ש"ע)</B> הצלפה, הלקאה, פרגול.
flax|dis	<B>(ש"ע)</B> פשתה תרבותית.<BR>בלשון הדיבור: פשתן. צמח בעל חשיבות במאגיה העממית ובפולקלור. משמש בכישופי פיות. מקודש לאלה הגרמאנית הולה ולאלה הנורדית פריג, שתיהן אלות של טוויה ואריגה. נחשב לצמח מגן מפני אנהולן, אויביה של האלה הולה. נחשב צמח ביתיות, פריון, יופי, נישואים טובים, אהבת אמת ונאמנות. שמו הלטיני Linium usitatissimum.
florite|fluorite	<B>(ש"ע)</B> פלוריט, פלורית (סוג אבן טובה).
flying	<B>(ש"ע)</B> תעופה, התעופפות.
flying dutchman	<B>(ש"ע)</B> ההולנדי המעופף.
flying ointment	<B>(ש"ע)</B> משחת תעופה.
folk magic	<B>(ש"ע)</B> כשף עממי.
folk witchcraft	<B>(ש"ע)</B> כשפים עממיים.
folklore	<B>(ש"ע)</B> פולקלור, ידע עממי, אמונה עממית.
footprints	<B>(ש"ע)</B> טביעות רגל.
forumla	<B>(ש"ע)</B> נוסחת קסם.
four quarters	<B>(ש"ע)</B> ארבע רוחות השמים.
fox fire	<B>(ש"ע)</B> זוהר רפאים.
foxglove	<B>(ש"ע)</B> אצבעונית ארגמנית. צמח רעיל המשמש במאגיה וברפואה העממית. שמו הלטיני Digitalis pupurea.
frankincense	<B>(ש"ע)</B> לבונה, בוסווליה.<BR>צמח המשמש מזה אלפי שנים לקטורת במזרח התיכון. שמו הלטיני Boswelia thurifera.
full moon	<B>(ש"ע)</B> ירח מלא, הלבנה במילואה.
futhark	<B>(ש"ע)</B> פותארק. האלף בית הרוני, משמש במאגיה ולהגדת עתידות.
gael	<B>(ש"ע)</B> גאלי.
gaelic	<B>(ש"ת)</B> גאלי.
galoi	<B>(ש"ע)</B> גלואי. כהן לאלת הפריון הגדולה קיבלי. הגלואי נהגו לסרס ולהלקות את עצמם בטקסים אורגיאסטיים רוויי דם לכבוד האלה.
gardenia	<B>(ש"ע) </B>גרדיניה.
garlic	<B>(ש"ע)</B> שום. בפולקלור ובמאגיה: צמח גירוש והתגוננות פסיכית. מקודש לאלת התבואה הרומאית קרס. מרכיב בשיקויי אהבה.
garnet	<B>(ש"ע)</B> גארנט, שחם (סוג אבן טובה). בפולקלור ובמאגיה, סמל אדמה, רחם, דם הרחם, נשיות ופריון. מקודשת לאלה פרספונה.
garter	<B>(ש"ע)</B> בירית. מכלי המכשפה. משמשת לסימון דרגת המכשפה ולזיהוי אחיות לאומנות הכשפים.
gate of heaven	<B>(ש"ע)</B> שער השמים.
gate of horn	<B>(ש"ע)</B> שער חלומות השווא, שער הקרן של פותרי חלומות.
gate of ivory	שער חלומות האמת, שער השן של פותרי חלומות.
gateway	<B>(ש"ע)</B> פתח המעגל.
gaul	<B>(ש"ע)</B> גולי, שמוצאו מגליה (בעת העתיקה: צרפת ובלגיה).
gem|gemstone	<B>(ש"ע) </B>אבן טובה, אבן יקרה, אבן חן.
genethlialogy	<B>(ש"ע)</B> אצטגנינות.
geode	<B>(ש"ע)</B> גאודה (סוג אבן טובה).
geomancy	<B>(ש"ע)</B> גאומנסיה (שיטת הגדת עתידות).<BR>
gesture	<B>(ש"ע) </B>סימון, מחווה, רמיזה בתנועה.
ghebre|gueber	<B>(ש"ע)</B> אמגוש, עובד אש (בפרס העתיקה).
ghost	<B>(ש"ע)</B> רוח המת, רוח רפאים, אוב.
ghoul	<B>(ש"ע)</B> גול. בפולקלור הערבי, סוג שד.
giant	<B>(ש"ע)</B> ענק.
giantomachy	<B>(ש"ע)</B> מלחמת הענקים, מלחמת איתנים.
ginger	<B>(ש"ע)</B> זנגביל, ג'ינג'ר. שורש המשמש בשיקויי אהבה מסוימים.
girdle measuring	<B>(ש"ע)</B> מדידת האזור.
glamour|glamor	<B>(ש"ע)</B> זוהר. במאגיה, כישוף שמטרתו לשנות את המרקם הפנימי של הפרסונה המאגית.
glass	<B>(ש"ע)</B> זכוכית, מראה, ראי.
glyph	<B>(ש"ע)</B> גילוף, תגליף. סמל מאגי שהוטען באנרגיה פסיכית.
gnome	<B>(ש"ע)</B> נום. במיתולוגיה הקלאסית, יצור דמוי אדם השוכן בעפר ומייצג את רוח יסוד האדמה.
goblet	<B>(ש"ע)</B> קובעת. מכלי המכשפה. מסמלת את יסוד המים, הרחם, הירח, הפוריות, הנשיות, המחזוריות וההכנסה בסוד. <BR>
goblin	<B>(ש"ע)</B> גובלין. יצור פלאי במיתולוגיה הקלטית-גולית.
god	<B>(ש"ע)</B> אל.
god of day	<B>(ש"ע)</B> השמש, אלוהי היום.
god of heaven	<B>(ש"ע)</B> יופיטר.
god of hell	<B>(ש"ע)</B> פלוטו.
god of love	<B>(ש"ע)</B> אלוהי האהבה.
god of the sea	<B>(ש"ע)</B> נפטון.
god of war	<B>(ש"ע)</B> מרס.
god of wine	<B>(ש"ע)</B> בכחוס.
goddess	<B>(ש"ע)</B> אלה.
goddess of corn	<B>(ש"ע)</B> קרס.
goddess of heaven	<B>(ש"ע)</B> יונו.
goddess of hell	<B>(ש"ע)</B> פרוסרפין, פרוסרפינה.
goddess of love	<B>(ש"ע)</B> ונוס.
goddess of the moon	<B>(ש"ע)</B> דיאנה.
goddess of war	<B>(ש"ע)</B> בלונה.
goddess of wisdom	<B>(ש"ע)</B> מינרווה.
gods	<B>(ש"ע)</B> אלים, אלוהים.
gold	<B>(ש"ע)</B> זהב. מתכת המסמלת את השמש והאור, עושר ושפע. במיתולוגיה הכנענית מקודשת לבעל, ענת, קודש, כושר וחסיס ואשרה.
goose	<B>(ש"ע)</B> אווז.
gooseberry	<B>(ש"ע)</B> חזרזר, עכבית, דמדמנית, ענבי שועל. צמח רעיל המשמש במאגיה וברפואה העממית. שמו הלטיני Ribes grossularia.
gorse	<B>(ש"ע)</B> אלגומין, אולקס. <BR>צמח המשמש במאגיה וברפואה העממית. שמו הלטיני Ulex europaeus.
goth	<B>(ש"ע)</B> גותי.
gothic	<B>(ש"ת)</B> גותי.
graal|grail	<B>(ש"ע)</B> גראל. הגביע הקדוש.
grain	<B>(ש"ע) </B>תבואה, גרעינים.
grammary	<B>(ש"ע)</B> דקדוקים. שיטה של מאגיה כתובה, הכוללת סמלים, חותמות וסימנים.
grape	<B>(ש"ע)</B> עינב.
grass	<B>(ש"ע)</B> דשא, עשב.
greencoatie	<B>(ש"ע)</B> ירוקת המעיל. סוג פייה ירוקה במיתולוגיה הקלטית.
greenie	<B>(ש"ע)</B> גריני. סוג פייה ירוקה במיתולוגיה הקלטית.
greenstone	<B>(ש"ע)</B> ירקן, פטדה. שם כולל לאבנים טובות בצבע ירוק.
gremlin	<B>(ש"ע)</B> גרמלין.
griffin|griffon|griphon	<B>(ש"ע)</B> גריפין.
grimorie	<B>(ש"ע)</B> גרימואר. ספר טקסים וכשפים מימי הביניים.
grounding	<B>(ש"ע)</B> קרקוע.
guardian spirit	<B>(ש"ע)</B> רוח שומרת.
gyre	<B>(ש"ע)</B> גייר. יצור פלאי שמקורו בסקוטלנד.
gyromancy	<B>(ש"ע)</B> נחש סיבובים (שיטת הגדת עתידות).
hackberry|hagberry	<B>(ש"ע)</B> גודגדנית.
hag	<B>(ש"ע)</B> האג. (שדה). דמות שככל הנראה התפתחה מאלת הפריון המצרית הק ואלת הכשפים הקטה בהתגלמותה המשולשת כאלה הזקנה.<HR><B>(ש"ע) </B>האג.<B> </B>כינוי למכשפה רעה.
hagstone|hag stone|holy stone	<B>(ש"ע)</B> אבן קמע, אבן המכשפות. <BR>בפולקלור ובמאגיה, אבן עם חור במרכזה, שביכולתה לגרש את כוחות הרשע. באירופה הכפרית נוהגים לענוד אבן כזאת לצווארי ילדים ובהמות בית כדי להגן עליהם. כמו כן נוהגים לתלות את האבן בחדרי שינה. בפולקלור האיטלקי האבן נחשבת שער או מפתח לעולם הפיות.
hair and nails	<B>(ש"ע)</B> שיער וציפורניים.
halo	<B>(ש"ע)</B> הילה, מעגל זיו.
halomancy	<B>(ש"ע)</B> נחש מלח (שיטת הגדת עתידות על פי תלוליות מלח).
hand of glory	<B>(ש"ע)</B> יד התהילה.
handfasting	<B>(ש"ע)</B> אחיזת ידיים. טקס חתונה ויקני.
handparting	<B>(ש"ע)</B> הפרדת ידיים. טקס גירושין ויקני.
hare	<B>(ש"ע)</B> שפן.
harpy	<B>(ש"ע)</B> הרפיה.
haruspex|haruspicy	<B>(ש"ע)</B> הרוספקסיה (שיטת הגדת עתידות באמצעות קרביים של בעלי חיים).
harvest	<B>(ש"ע)</B> קציר, אסיף.
harvest festival	<B>(ש"ע)</B> חג האסיף, חג הקציר.
harvest home	<B>(ש"ע)</B> כינוי אנגלי מסורתי לחג הקציר בלתיין, אחד משמונת חגי השמש בגלגל השנה הפגני. נחגג בתאריך 30 לאפריל.<BR><B>(ש"ע) </B>כינוי לשירת קוצרים אנגלית מסורתית בחג בלתיין.
harvest moon	<B>(ש"ע)</B> ירח הקציר, חודש האסיף. כינוי לירח המלא בחודש ספטמבר.
haunt	<B>(פ')</B> לרדוף.
haunted	<B>(ש"ת)</B> רדוף, רדוף רוחות.
haunting	<B>(ש"ע)</B> רדיפה.
hawk	<B>(ש"ע)</B> נץ.
hawk's eye|hawk eye	<B>(ש"ע)</B> עין הנץ (סוג אבן טובה).
hawthorn	<B>(ש"ע)</B> עוזרר. עץ החודש השישי בלוח העצים הקלטי: 13 מאי - 9 יוני. אחד מן העצים המסורתיים של ליל ולפורגיס. מקודש לאל הגרמאני תונור. על פי האמונה העממית, תונור ברא את העץ במכת ברק. אחד מתשעת הצמחים ששימשו בטקסי שריפה בלוויות בתרבות הנורדית. שמו הלטיני Crataegus oxyacantha.
hazel|hazel nut|hazelnut	<B>(ש"ע)</B> אלסר, לוז, פונדק. <BR>עץ החודש התשיעי בלוח העצים הקלטי: 5 אוגוסט - 1 ספטמבר. פירותיו משמשים להגדת עתידות אהבה בליל סמהין. מקודש לאל הגרמני תונור. ככל הנראה שימש להכנת מקלות רונות בסקנדינביה. שמו הלטיני Corylus avellana.
headdress	<B>(ש"ע)</B> מצנפת, עטרה, כסות ראש, כיסוי ראש.
healer	<B>(ש"ע)</B> מרפא, הילר.
healing	<B>(ש"ע)</B> ריפוי, מרפא, הילינג.
healing spell	<B>(ש"ע)</B> כישוף ריפוי.
heathen	<B>(ש"ע)</B> פגני. <BR><B>(ש"ע) </B>שם גנאי למאמין פגני.
heather	<B>(ש"ע)</B> אברש. קבוצת צמחים בעלי חשיבות במאגיה וברפואה העממית. שם לטיני: Erica.
hedge witch	<B>(ש"ע)</B> מכשפת בקתה. כינוי למכשפה מתבודדת העוסקת בריפוי עממי ובכשפים טבעיים.
hedgehog	<B>(ש"ע)</B> קיפוד.
heka|hik	<B>(ש"ע)</B> הקה. מאגיה מצרית (המהווה חלק בלתי נפרד ממארג החיים החברתיים והדתיים). משמעות המילה המקורית מתייחסת לכוח האלוהי הראשוני שניתן לאל בורא העולם בראשית הכל.
hekau	<B>(ש"ע)</B> הקאו. שמות כוח בדת המצרית. מילים שביכולתן לחולל שינויים מאגיים.
heliolater	<B>(ש"ע)</B> עובד השמש.
heliolatry	<B>(ש"ע)</B> פולחן השמש.
heliolithic	<B>(ש"ע)</B> של תרבות עובדי השמש.
heliotrope	<B>(ש"ע)</B> עוקץ העקרב. צמח המשמש במאגיה וברפואה העממית. שמו הלטיני Heliotropium peruviana.<HR><B>(ש"ע) </B>הליוטרופ, אבן דם.<BR>סוג אבן טובה המשמשת במאגיה וברפואה העממית.
hellbroth	<B>(ש"ע)</B> מרק שטנים, תבשיל מכשפות, מרקחת כשפים.
hellcat	<B>(ש"ע)</B> חתולה מרשעת, כינוי למכשפה רעה.
hellebore	<B>(ש"ע)</B> יחנון. צמח בר ממשפחת הנוריתיים.
hellfire	<B>(ש"ע)</B> אש הגיהנום.
hellhag	<B>(ש"ע)</B> כינוי למכשפה רעה.
hematite	<B>(ש"ע)</B> המטיט (סוג אבן טובה).
hemlock	<B>(ש"ע)</B> רוש עקוד. <BR>סוג צמח ארסי המשמש במאגיה וברפואה העממית. שמו הלטיני Conium maculatum.
hemp	<B>(ש"ע)</B> קנבוס, מריחואנה. צמח הלוצינוגני ממשפחת הסולניים.
henbane	<B>(ש"ע)</B> שכרון שחור. <BR>צמח ארסי ממשפחת הסולניים, המשמש במאגיה וברפואה העממית. מרכיב נפוץ במשחות תעופה. שמו הלטיני Hyocyamus niger.
henge	<B>(ש"ע)</B> מתחם. אזור מגודר באבנים (או לעתים ביתדות עץ), משמש לטקסים מאגיים ודתיים.
hepatoscopy	<B>(ש"ע)</B> הפטוסקופיה (שיטת הגדת עתידות בכבד בעל חיים שהוקרב קרבן).
heptagram	<B>(ש"ע)</B> הפטגרם. כוכב משובע. סמל קדוש בתרבות הבבלית העתיקה, מסמל את הספרה שבע המיסטית.
herb	<B>(ש"ע)</B> עשב.
herb tea|herbal tea	<B>(ש"ע)</B> תה עשבים, תה צמחים.
herbal	<B>(ש"ת)</B> עשבי, עשבוני, צמחי.
herbalism	<B>(ש"ע)</B> עשבונאות.
herbarium	<B>(ש"ע)</B> עשבייה.<HR><B>(ש"ע) </B>אוסף צמחים מיובשים.
hereditary|hereditary witch	<B>(ש"ע)</B> מכשפה יורשת. מכשפה או מאמינה פגנית, הטוענת שאמונותיה נובעות ממסורת משפחתית.
herma	<B>(ש"ע)</B> הרמה. פסלון האל היווני הרמס.
hex	<B>(ש"ע)</B> הקס.
hexagram	<B>(ש"ע)</B> הקסגרם, כוכב משושה, מגן דוד. סמל מאגי יהודי. במאגיה, מסמל את העקרון ההרמטי, מה שממעל הוא שמתחת.
hexenbesen	<B>(ש"ע)</B> מטאטא המכשפות. אחד מכלי המכשפה, משמש לטיהור ולטקסי פריון.
hibiscus	<B>(ש"ע)</B> היביסקוס.
hierophant	<B>(ש"ע)</B> הירופאנט. כהן בטקסי מסתורין, המתגלים רק למוכנסים בסוד.
hieros gamos	<B>(ש"ע)</B> הירוס גאמוס, הנישואין הקדושים, קדש. טקס פריון פגני הכולל קיום יחסי מין קדושים על המזבח.
high priest	<B>(ש"ע)</B> כהן גדול. תואר למכשף ויקני בדרגה שלישית, המסייע לכהנת גדולה בהובלת אסיפה או מעגל.
high priestess	<B>(ש"ע)</B> כהנת גדולה. תואר למכשפה ויקנית בדרגה שלישית המובילה אסיפה או מעגל.
higher self	<B>(ש"ע)</B> האני הגבוה. במאגיה ובתיאולוגיה, העצמיות הרוחנית והאמיתית.
hiolite	<B>(ש"ע)</B> היוליט (סוג אבן טובה).
hippocampus	<B>(ש"ע)</B> היפוקמפוס, סוס דג, קרן אמון. מפלצת ימית במיתולוגיה היוונית והמצרית.
hippogriff|hippogriph hippogryph	<B>(ש"ע)</B> היפוגריף. סוס מעופף במיתולוגיה היוונית.
hiving off	<B>(ש"ע)</B> היפרדות בצוותא. הקמת אסיפת מכשפות חדשה על ידי קבוצת מכשפות שפורשת מאסיפה קיימת.
hold spellbound	<B>(פ')</B> לאחוז בחבלי קסם.
holly	<B>(ש"ע)</B> צינית, אדר מצוי. <BR>אחד מן הצמחים המסורתיים של חג יול הפגני, סמל לחורף ולחצי המתמעט של השנה. עץ החודש השמיני בלוח העצים הקלטי: 8 יולי - 4 אוגוסט. שמו הלטיני Ilex aquifolium.
holy	<B>(ש"ת)</B> קדוש.
honey	<B>(ש"ע)</B> דבש. מקודש לאלת צמתי הדרכים היוונית הקטה. מרכיב חשוב בשיקויי אהבה.
honey cakes	<B>(ש"ע)</B> עוגות דבש. מן המנחות המסורתיות לאלת המכשפות הקטה. המאמינים נוהגים להשאיר אותן בצמתי דרכים בלילות ירח מלא עבור האלה.
honeysuckle	<B>(ש"ע)</B> יערה, עזנית.
horehound	<B>(ש"ע)</B> מרווה, מרוביון.
horn	<B>(ש"ע)</B> קרן.
horn of plenty	<B>(ש"ע)</B> קרן השפע, קורנוקופיה.
hornbeam	<B>(ש"ע)</B> אלה לבנה (עץ).
horology	<B>(ש"ע)</B> הורולוגיה. במצרים העתיקה, אומנות ספירת השעות והימים, בה עסקו הכוהנים. למניין השעות היתה חשיבות בפולחן ספינת השמש.
horoscope	<B>(ש"ע)</B> הורוסקופ.
horoscoper	<B>(ש"ע)</B> אצטגנין, אסטרולוג.
horoscopist	<B>(ש"ע)</B> אצטגנין, אסטרולוג.
horoscopy	<B>(ש"ע)</B> אצטגנינות, אסטרולוגיה.
horse	<B>(ש"ע)</B> סוס.
horseshoe	<B>(ש"ע)</B> פרסה.
hot cross bun	<B>(ש"ע)</B> לחמנית צלב, גלוסקת הצלב.
house of god	<B>(ש"ע)</B> בית אל.
household gods	<B>(ש"ע)</B> תרפים.
houseleek|thorsbeard|thundersbeard	<B>(ש"ע)</B> סמפרויוום טקטורום. צמח הגנה מפני עין הרע, כשפים וברקים. שם לטיני: Sempervivum tectorum.
hu	<B>(ש"ע)</B> הו. בדת המצרית, עיקרון הדיבור האלוהי. על פי רעיון זה, יש כוח מאגי עצום להפקת צלילים בדיבור. לכן ייחסו המצרים חשיבות רבה להגייה נכונה ומדויקת של מילות קסם.
hunter's moon	<B>(ש"ע)</B> ירח הציידים. כינוי לירח המלא בחודש אוקטובר.
hydromancy	<B>(ש"ע)</B> נחש מים (שיטת הגדת עתידות).
hyssop	<B>(ש"ע)</B> אזוב רפואי. <BR>צמח המשמש במאגיה וברפואה העממית. שמו השליטני Hyssopus officinalis.
ichtyolatry	<B>(ש"ע)</B> פולחן דגים.
ichtyomancy	<B>(ש"ע)</B> נחש דגים (שיטת הגדת עתידות).
icon	<B>(ש"ע)</B> צלמית.
idol	<B>(ש"ע)</B> אליל.
ignis fatuus	<B>(ש"ע)</B> זהר רפאים.
ill wisher	<B>(ש"ע)</B> דורש רע, מארר, אורר.
ill wishing	<B>(ש"ע)</B> מארה.
image	<B>(ש"ע)</B> דמות, תמונה.
immortality	<B>(ש"ע)</B> אלמוות.
imp	<B>(ש"ע)</B> אימפ, שד טבעת, שד בקבוק.
in the arms of Morpheus	<B>(ש"ע) </B>בזרועות מורפאוס, ישן, רדום.
in the broom closet	<B>(ש"ע) </B>בארון המטאטאים. תיאור למכשפה שלא חושפת את אמונותיה ופולחניה בפומבי, מחשש לרדיפות או דעות קדומות.
incantation|incant	<B>(ש"ע)</B> לחש. במאגיה, דקלום טקסי של מילות קסם. אחד משלושת חלקי הכישוף, הקשור לדיבור.
incense	<B>(ש"ע) </B>קטורת. תערובת צמחים, מקלות או קוביות השורפים בכלי מיוחד כמנחה לאלים, לטיהור או כדי לעורר כוח פסיכי. מייצגת את רוח יסוד האויר.
incubus	<B>(ש"ע)</B> אינקובוס (שד).
infusion	<B>(ש"ע)</B> חליטה. בפולקלור ובמאגיה, הדרך הנפוצה ביותר להכנת שיקויים על ידי יציקת מים חמים על צמחים.
initiate	<B>(ש"ע)</B> שותף סוד. אדם שהתקבל לאסיפת מכשפות או למסדר מאגי ונכנס בסודות הקבוצה.<HR><B>(ש"ע) </B>שותף סוד. במסדרים המאגיים והמיסטיים, אדם שחווה הארה דתית וקרבה לאלוהות, המכתיבה חיים בעלי אופי מסוים, הכוללים לימודים והכשרה רוחנית ("העבודה הגדולה")
initiation	<B>(ש"ע)</B> הכנסה בסוד.
inner eye	<B>(ש"ע)</B> עין פנימית, העין השלישית.
inner planes	<B>(ש"ע)</B> המישורים הפנימיים. כינוי למישורי התודעה האסטרליים אליהם ניתן להגיע באמצעות התת מודע.
invocation	<B>(ש"ע)</B> העלאה. קריאה או משיכה של אלוהות או ישות אסטרלית לתוך גוף הקורא, כך שהאדם סופג את הישות הרוחנית והופך לחלק ממנה.
invoke	<B>(ש"ע)</B> להעלות. העלאה היא קריאה או משיכה של אלוהות או ישות אסטרלית לתוך גוף הקורא, כך שהאדם סופג את הישות הרוחנית והופך לחלק ממנה.<BR>
inward silence	<B>(ש"ע)</B> שקט פנימי. השתקת מחשבות ורגשות טפלות או בלתי רלוונטיות, המפריעות להתרכזות במטרה המאגית.
iron	<B>(ש"ע)</B> ברזל.
islands of the blest|islands of the blessed	<B>(ש"ע)</B> משכנות אהובי האלים. גן העדן במיתולוגיה הקלטית.
ivory	<B>(ש"ע)</B> שנהב.
ivy	(ש"ע) קיסוס. עץ החודש האחד עשר בלוח העצים הקלטי: 30 ספטמבר - 27 אוקטובר. מתייחס למין הקיסוס המצוי. שמו הלטיני Hedera helix.
jacinth	<B>(ש"ע)</B> יקינטון (צמח)<HR><B>(ש"ע) </B>כדכד (סוג אבן טובה).
jack-o'-lantern|jack o lantern|jack o' lantern	<B>(ש"ע)</B> ג'ק-או-לנטרן, מנורת ג'ק (דלוע או לפת שרוקנו מתוכנם ונתחב בהם נר - מנהג בסו-ווין, חג המתים, אחד משמונת חגי השמש בגלגל השנה הפגני. נחגג בתאריך 31 לאוקטובר).<BR><B>(ש"ע) </B>זהר רפאים.
jade|jadestone	<B>(ש"ע)</B> ג'ייד, ירקן (סוג אבן טובה).
jasmine	<B>(ש"ע)</B> יסמין שיחני.<BR>צמח בושם המשמש במאגיה וברפואה העממית. נחשב לצמח אהבה. שמו הלטיני Jasminum fruitcans.
jasper	<B>(ש"ע)</B> ישפה, ג'ספר (סוג אבן טובה).
jet	<B>(ש"ע)</B> ג'ט, שחרון (סוג אבן טובה).
jumpers	<B>(ש"ע)</B> קפצנים. כוהני מרס שנקראו כך משום שריקדו וקיפצו ברחובות רומא במהלך תהלוכה דתית לכבוד מרס.
juniper	<B>(ש"ע)</B> ערער מצוי.<BR>צמח שגרגיריו משמשים במאגיה וברפואה העממית. מקודש לאל הנורדי תונור. על פי האמונה העממית באיסלנד, אין לערבב את ענפיו עם ענפי חוזרר להדלקת מדורות. נחשב צמח מחייה ומשמש להכנת קטורת. שמו הלטיני Juniperus communis.
kheper	<B>(ש"ע)</B> "המגלגלת". במצרים העתיקה, כינוי לחרפושית הקדושה, המגלגלת את השמש על פני השמים.
king	<B>(ש"ע)</B> מלך.
king of terrors	<B>(ש"ע)</B> מלך בלהות, מוות.
king of the forest	<B>(ש"ע)</B> אלון.
king of the waning year	<B>(ש"ע)</B> מלך השנה המתמעטת, מלך צינית.
king of the waxing year	<B>(ש"ע)</B> מלך השנה המתמלאת, מלך אלון.
kitchen magic|kitchen witchcraft	<B>(ש"ע)</B> כשף מטבח. שיטה מאגית, המשתמשת בכלים פשוטים ויומיומיים להטלת כשפים.
kitchen witch	<B>(ש"ע)</B> מכשפת מטבח. מכשפה המשתמשת באמצעים ובכלים יומיומיים ופשוטים לשם הטלת כשפים ופולחן.
knight templar|templar|templer	<B>(ש"ע)</B> טמפלר, אביר המקדש.
knot	<B>(ש"ע)</B> קשר.
labrys|labris|labrus	<B>(ש"ע)</B> לביריס. גרזן מלחמה עם להב כפול שהיה בשימוש בתקופות קדומות. כיום משמש סמל דתי של עוצמתה הרוחנית של האשה ושל הכוח היוצר והלוחם הנשי.
lace agate	<B>(ש"ע)</B> לייס אגת (סוג אבן טובה).
lamen	<B>(ש"ע)</B> לאמן. לוח מתכת חרוט סמלים מאגיים. עונדים אותו במהלך טקסים מסוימים.
lamia	<B>(ש"ע)</B> למיה (שדה).
lampadomancy	<B>(ש"ע)</B> נחש שלהבת המנורה (שיטת הגדת עתידות).
lapidolite	<B>(ש"ע)</B> לפידוליט (סוג אבן טובה).
lapis lazuli	<B>(ש"ע)</B> אבן התכלת.<BR>לפיס לזולי, אבן השמים. סוג אבן טובה בצבע כחול כהה עם נקודות מתכת בצבע זהב. אחת משלוש אבני החן הקדושות במצרים העתיקה (האחרות הן קרנליאן וטורקיז). אבן חשובה במיתוסים של כנען, מקודשת לאלה ניכל, לאל יריח, לאל בעל ולאל כושר וחסיס.
lavender	<B>(ש"ע)</B> אזוביון דגול.<BR>נקרא גם לבנדר. צמח ריחני הנפוץ במרקחות ובשיקויים שונים במאגיה וברפואה העממית. בדרך כלל נחשב לצמח אהבה. שמו הלטיני Lavandula augustfolia.
lay	<B>(ש"ע)</B> ליי. בתרבות הקלטית גלית של בריטני, שיר של הבארד. ידוע יותר בשם האירי קטל.<BR>
laying of hands|hands laying	<B>(ש"ע)</B> הנחת ידיים (שיטת ריפוי).
leap year	<B>(ש"ע)</B> שנה מעוברת.
lemon	<B>(ש"ע)</B> לימון.
leopard skin	<B>(ש"ע)</B> עור הנמר, לאופרד סקין (סוג אבן טובה).
leprechaun	<B>(ש"ע)</B> לפרקון, לפרקאון.
levels	<B>(ש"ע)</B> מישורים.
levitation	<B>(ש"ע)</B> ריחוף. טכניקה מאגית שבה הגוף עולה מעל פני הקרקע.
ligature|aigulette	<B>(ש"ע)</B> כישוף לולאה.
lilac	<B>(ש"ע)</B> לילך. <BR>צמח המשמש במאגיה וברפואה העממית כמרכיב אהבה ותשוקה. נחשב למקודש לאלה אישתר ולמלוותה הציפור לילית. שמו הלטיני Syringa vulgaris.
lily of the valley|Our Lady's Tears|lily-of-the-valley|mayflower	<B>(ש"ע)</B> שושן, חבצלת, שושנת העמקים, חבצלת השרון. צמח המשמש במאגיה וברפואה העממית כמרכיב אהבה ותשוקה. הפרח מקודש לאלת המלחמה והתשוקה הכנענית ענת. על פי האמונה העממית הנורווגית, נברא כאשר האלה החליטה שהחורף חשוף ועגום מדי. היא נטלה חופן שלג ויצרה ממנו את הפרח. אחד מן הפרחים המסורתיים של ליל ולפורגיס. שמו הלטיני Convallaria magalis.
linden	<B>(ש"ע)</B> טיליה. <BR>בתרבות הגרמאנית, עץ הגנה וחוזק. באמונה העממית השוודית, עץ שיפוט צודק ונכון ומקודש לאל טיר. הנורדים מאמינים כי בעץ שוכנות רוחות הבית הטובות. הגרמאנים האמינו כי דוורפים שוכנים בו והחשיבו אותו כעץ חיי נצח ואלמוות. שם לטיני: Tilia.<BR>
lineage	<B>(ש"ע)</B> שלשלת יוחסין.
lithoboly	<B>(ש"ע)</B> ליתובוליה.
litholatry	<B>(ש"ע) </B>פולחן אבנים.
lithomancy	<B>(ש"ע)</B> נחש אבנים (שיטת הגדת עתידות).
living sacrifice	<B>(ש"ע)</B> קורבן חי.
logomancy	<B>(ש"ע)</B> נחש מילות קסת (שיטת הגדת עתידות).
lore	<B>(ש"ע)</B> פולקלור, אמונה עממית, מסורת בעל פה.
lotus	<B>(ש"ע)</B> לוטוס. צמח מקודש בדת המצרית וקשור לשמש. על פי אחת מאגדות הבריאה המצריות, האל רע בקע מתוך פרח הלוטוס. הפרח מקודש גם לאלה קודש, דמותה של אלת המלחמה הכנענית ענת כאלת מין קדוש.
love magic	<B>(ש"ע)</B> כשף אהבה.
lunar month	<B>(ש"ע)</B> חודש הלבנה, חודש ירחי.
lunar tide	<B>(ש"ע)</B> מועד ירחי.
lunar year	<B>(ש"ע)</B> שנת הלבנה, שנה ירחית.
lycanthropy	<B>(ש"ע)</B> ליקנתרופיה.
mace	<B>(ש"ע)</B> אלה.
machairomancy	<B>(ש"ע)</B> נחש סכינים (שיטת הגדת עתידות באמצעות סכינים או חרבות).
macrocosm	<B>(ש"ע)</B> מקרוקוסמוס. מונח המתאר את היקום בכללותו, בניגוד למיקרוקוסמוס, המתאר את התגלמות היקום הפרטנית, למשל באדם.
mage	<B>(ש"ע)</B> מג. מכשף שכליו המאגיים הם הרוח, הנפש וכוח הרצון בלבד.
magi	<B>(ש"ע)</B> אמגושים, חכמי קדם (צורת רבים של magus).
magian	<B>(ש"ע)</B> אמגוש, חכם, מכשף.
magianism	<B>(ש"ע)</B> כישוף, כשפים.
magic	<B>(ש"ע)</B> מאגיה, כשף.
magic circle|circle|the circle	<B>(ש"ע)</B> מעגל קסם.
magic eye	<B>(ש"ע)</B> עין קסם, עין פנימית, עין שלישית.
magic mirror	<B>(ש"ע)</B> ראי קסם.
magic words	<B>(ש"ע)</B> מלות קסם.
magical	<B>(ש"ע)</B> כישופי, מכושף.
magician	<B>(ש"ע)</B> מג.
magick	<B>(ש"ע)</B> מאגיה. צורת איות ייחודית שטבע המכשף אליסטייר קראולי כדי להבחין את הקסם הטבעי מקסם הבמה.
magnolia	<B>(ש"ע)</B> מגנוליה.
magus	<B>(ש"ע)</B> אמגוש. כהן בכת עובדי האש בפרס העתיקה.<HR><B>(ש"ע) </B>מאגוס. מכשף מיומן בדרגה גבוהה.<BR>
maiden	<B>(ש"ע)</B> עלמה. אשה שטרם הרתה וילדה. האספקט הראשון של אלת הפריון המשולשת בויקה.<HR><B>(ש"ע) </B>עלמה. חברה באסיפת המכשפות שטרם הרתה וילדה, ותקפידה לסייע לכהנת הגדולה במהלך הטקסים.<BR>
maidenhair	<B>(ש"ע)</B> שערות שולמית מצויות.<BR>צמח המשמש במאגיה וברפואה העממית. נחשב לצמח תשוקה, זוהר ויופי ומקודש לאלות האהבה. נקרא גם יועזר, שעיר אל בנאת, שערת אל עולה. שמו הלטיני Adiantum Capillus-veneris.
major arcana	<B>(ש"ע)</B> הארקנה הראשית. הסדרה הראשונה בקלפי הטארוט.
make an oath	<B>(פ')</B> להישבע.
mal	<B>(ש"ע)</B> מחלה.
malachite	<B>(ש"ע)</B> מלכית, מלכיט, מלאכית (סוג אבן טובה, בצר נחושת).
maledict	<B>(ש"ת)</B> מקולל, ארור.
malediction	<B>(ש"ע)</B> קללה, מארה.
malefaction	<B>(ש"ע)</B> מעשה רע.
malefactor	<B>(ש"ע)</B> עושה רע, גומל רע.
maleficia	<B>(ש"ע)</B> מלפיקיה, כשף מרושע, כשפים רעים.
malignancy	<B>(ש"ע)</B> זדון, רשע, ממאירות, רוע לב.
malignant	<B>(ש"ע) </B>זדוני, מרושע, רע לב, ממאיר.
malison	<B>(ש"ע)</B> קללה, מארה.
mallow	<B>(ש"ע)</B> חלמית מצויה. <BR>צמח ממשפחת החלמיתיים, בעל פרחים ורודים סגולים ועלים הגורמים לגירוי בעור. משמש במאגיה וברפואה העממית. שמו הלשטיני Malva nicaeensis.<BR>
maltese cross	<B>(ש"ע)</B> צלב מלטי. צלב בעל גפיים שווים ורחבים בקצוות.
man of god	<B>(ש"ע)</B> איש האלוהים, כהן, קדוש.
mana	<B>(ש"ע)</B> מנא, כוח מאגי.
mandrake	<B>(ש"ע)</B> דודא. <BR>צמח בר רב שנתי רעיל מאוד ממשפחת הסולניים. אחד מן הצמחים החשובים ביותר במאגיה. נקרא גם דודאים, דודי, יברוח, סביסק. שמו הלטיני Atropa mandragora.
manism	<B>(ש"ע)</B> פולחן מתים, פולחן הרפאים.
maple|Freo|Hlin	<B>(ש"ע)</B> אדר. עץ חורש ממשפחת האדריים, מקודש בתרבות הנורדית והאנגלו סקסית. נקרא גם פריאו, ומקודש לאלת הכשפים והפריון הנורדית פרייה. שמו הלטיני של העץ: Acer.
mare	<B>(ש"ע)</B> כתם שחור בירח<HR><B>(ש"ע) </B>רו<B> </B>ח ביעותים, רוח לילה.<BR>
mare nostrum	<B>(ש"ע)</B> הים שלנו (בפי הרומאים), הים התיכון.
margaritomancy	<B>(ש"ע)</B> נחש פנינים, נחש מרגליות (שיטת הגדת עתידות).
marguerite	<B>(ש"ע)</B> חננית רב שנתית. צמח ממשפחת המורכבים בעל פרחים בצבעי לבן, לילך וצהוב. על פי רוב אינו צומח בארץ ישראל.
marigold	<B>(ש"ע)</B> ציפורני חתול רפואיות. <BR>צמח ממשפחת המורכבים, בעל פרחים קטנים וצהובים. משמש במאגיה וברפואה העממית. היוונים הקדמונים האמינו כי חלומות על הפרח מבשרים הצלחה, עושר ובמיוחד נישואים טובים ומאושרים. במחוז בריטני בצרפת מאמינים, כי נערה צעירה שתהלך יחפה על מרבד ציפורני חתול, תוכל להבין את שפת הציפורים, כלומר את שפת האהבה. בתקופת המלך הנרי השמיני באנגליה נהגו מחזרים לשלוח סלי ציפורני חתול לאהובותיהן ב"יום הגבירה", 25 למרץ. שמו הלטיני Calendula officinalis.
marjoram	<B>(ש"ע)</B> אזובית מצויה. <BR>נקרא גם מיורן, אזובית, אורגנו. בן שיח ממשפחת השפתניים המשמש במאגיה וברפואה העממית. שמו הלטיני Origanum vulgare.
martian	<B>(ש"ע)</B> של מרס.
marvel	<B>(ש"ע)</B> פלא, נס.
mascot|mascotte	<B>(ש"ע)</B> סימן טוב, קמע, סגולה.
mast	בלוטים, פירות האלון.
master|magister	<B>(ש"ע)</B> מסטר. כינוי למנהיג רוחני במאגיה טקסית.<BR>
mater	<B>(ש"ע)</B> אם, אמא.
math	<B>(ש"ע)</B> קציר.
matriarch	<B>(ש"ע)</B> מטריארך.
maythen	<B>(ש"ע)</B> קחון אצילי. אחד מתשעת הצמחים המרפאים של המיתולוגיה האנגלו סקסית. שמו הלטיני Anthemis nobilis
mead	<B>(ש"ע)</B> תמד, מי דבש.
measure	<B>(ש"ע)</B> חבל מידות.
medicine	<B>(ש"ע)</B> תרופה, סם מרפא.
medicine dance	<B>(ש"ע)</B> ריקוד רפואי, ריקוד רפואה. טקס שמאני לגירוש מחלה או להתרת כישוף.
medicine man	<B>(ש"ע)</B> רופא אשף, מרפא שמאני.
medieval	<B>(ש"ע)</B> של ימי הביניים, ביניימי.
medievalism	<B>(ש"ע)</B> רוח ימי הביניים, רוח ביניימית, מנהג ביניימי.
medievalist	<B>(ש"ע)</B> חוקר ימי הביניים, חוקר מנהגי ימי הביניים.
meditation	<B>(ש"ע)</B> מדיטציה. טכניקת כוונון המוח והנפש לשקט נפשי. הטכניקה נפוצה כמעט בכל הדתות, אך ידועה בעיקר בבודהיזם.
medium	<B>(ש"ע)</B> מדיום.
mediumistic	<B>(ש"ע)</B> מדיומי, מדיומלי.
melia	<B>(ש"ע)</B> אדזרכת. עץ נוי ממשפחת האזדרכתיים. פירותיו ארסיים ומכילים שמן. בעל חשיבות ברפואה העממית. שמו הלטיני Melia azedarach.
menhir	<B>(ש"ע)</B> מנהיר, יד, גלעד.
mens agitat molem	<B>(ש"ע)</B> לטינית: הרוח תניע את החומר.
mentha	<B>(ש"ע)</B> מנתה. עשב רב שנתי ממשפחת השפתניים, בעל ניחוח מרענן וחריף.
mermaid	<B>(ש"ע)</B> בתולת ים, בת ים. יצור פלא שחציו העליון אשה וחציו התחתון דג. חיה בים ונוהגת לפתות מלחים ולטבע את ספינותיהם.
merman	<B>(ש"ע)</B> בן ים. יצור פלא שחציו העליון עלם וחציו התחתון דג. <BR>
merry meet|mm	<B>(ש"ע)</B> ברכת שלום ויקנית נפוצה.
merry part|mp	<B>(ש"ע)</B> ברכת פרידה ויקנית נפוצה.
merrythought	<B>(ש"ע)</B> עצם המשאלות (זוג עצמות בחזה התרנגולת).
metamorphosis	<B>(ש"ע)</B> שינוי צורה, מטמורפוזה.
metaphysical	<B>(ש"ת)</B> מטפיזי.
metaphysician	<B>(ש"ע)</B> מטפיזיקאי.
metaphysics	מטפיזיקה. חקר הדברים שמעבר לטבע.
metempsychosis	<B>(ש"ע)</B> גלגול נשמות.
meteoromancy	<B>(ש"ע)</B> נחש תופעות אטמוספריות (שיטת הגדת עתידות על פי רעמים, ברקים, מטאורים וכדומה).
meteroid|meteor|meteorite	<B>(ש"ע)</B> מטאוריט, אבן שמים, אבן זיק, מטאור.
microcosm	<B>(ש"ע)</B> מיקרוקוסמוס. במאגיה, העולם בתוך האדם, העולם הקטן והפרטני המקביל למקרוקוסמוס.
middle ages	<B>(ש"ע)</B> ימי הביניים.
midnight	<B>(ש"ע)</B> חצות הלילה, חצות לילה, חצות הליל, חצות. בפולקלור ובמאגיה: זמן טוב לכשפים.
might	<B>(ש"ע)</B> כוח, חוזק, און, עוצמה, גוברה, חוסן.
mildew	<B>(ש"ע)</B> קמחון (מחלת צמחים).
milk thistle|thistle	<B>(ש"ע)</B> גדילן מצוי.<BR>נקרא גם בלשון הדיבור: קוץ, דרדר, ברקן. צמח המשמש במאגיה וברפואה העממית. שמו הלטיני Sylibum marianum.
minor arcana	<B>(ש"ע)</B> הארקנה המשנית. הסדרה המשנית בקלפי הטארוט.
minotaur	<B>(ש"ע)</B> מינותור, מינותאור, מינוטאור.
miracle	<B>(ש"ע)</B> נס.
miraculous	<B>(ש"ע)</B> נסי.
mirage	<B>(ש"ע)</B> מיראז', תעתוע, חזיון תעתועים.
mirror	<B>(ש"ע)</B> מראה, ראי.
mirror book	<B>(ש"ע)</B> ספר המראה. על פי המכשף הויקני סקוט קנינגהם: מחברת שבה על המכשפה המתלמדת לכתוב את כל מה שקשור להתקדמותה בלימוד אומנות הכשפים.
mistletoe	<B>(ש"ע)</B> דבקון לבן. <BR>נקרא גם הנורג, הרנוגא, חרנוגא. צמח מעוצה ורעיל ממשפחת ההרגוניים. אחד מן העשבים המסורתיים של חג יול, אחד משמונת חגי השמש בגלגל השנה הפגני, שנחגג בתאריך 21 לדצמבר. על פי אמונת השבטים הנורדיים והגרמאניים, השיח שממנו גילף אל האש לוקי את החץ שהרג את היפה והטוב מכל האלים, בלדר. הנורדים גם מאמינים כי הצמח הופך לעץ במכת ברק ולכן מקשרים אותו לאל הרעם תור או דונור. באמונה הגרמאנית זהו צמח הגנה מפני מכשפות ושריפות. ובעל סגולות פריון וריפוי. שמו הלטיני Viscum album.
moabite	<B>(ש"ת)</B> מואבי.
moabitess	<B>(ש"ע)</B> מואבית, אשה מואבית.
monster	<B>(ש"ע)</B> מפלצת.
month	<B>(ש"ע)</B> חודש, ירח.
monument	<B>(ש"ע)</B> מצבה, יד, ציון, גלעד, מצבת זכרון.
moon	<B>(ש"ע)</B> ירח, לבנה, סהר, המאור הקטן.
moonbeam	<B>(ש"ע)</B> קרן ירח.
moonlight	<B>(ש"ע)</B> אור ירח.
moonlit	<B>(ש"ע) </B>מואר באור הירח.
moonset	<B>(ש"ע)</B> שקיעת הירח.
moonshine	<B>(ש"ע)</B> אור ירח.
moonstone|moon stone	<B>(ש"ע)</B> מונסטון, אבן הירח (סוג אבן טובה).
morning star	<B>(ש"ע)</B> אילת השחר, כוכב הבוקר, כוכב השחר.
morris|morris dance	<B>(ש"ע)</B> ריקוד אנגלי עממי עתיק. <BR><HR><B>(ש"ע)</B> משחק מדלת לדלת בליל חג המתים באנגליה.
mortar	<B>(ש"ע)</B> מכתש, מכתשת, מדוכה.
moss agate	<B>(ש"ע)</B> מוס אגת (סוג אבן טובה).
mother	<B>(ש"ע)</B> אם, אמא, יולדת, מטרונה, מטרונית.
mother of all living	<B>(ש"ע)</B> אם כל חי.
mother of pearl	<B>(ש"ע)</B> אם הפנינה (סוג צדף).
mother redcap	<B>(ש"ע)</B> אמא כיפה אדומה. כינוי למכשפה ומרפאה עממית באנגליה.
moyen age	<B>(ש"ע)</B> ימי הביניים.
mugwort	<B>(ש"ע)</B> לענה מצויה.<BR>נקרא גם ארטימיסיה. אחד מתשעת הצמחים המרפאים במיתולוגיה האנגלו סקסית. נחשב לאחד הצמחים המסורתיים של ליל היפוך הקיץ. על פי האמונה העממית, זרים של הצמח יגנו מפני רעמים וגנבים; ענידת הצמח בחגורה תגן מפני מכשפות, רוחות רפאים ומזל ביש. שמו הלטיני Artemisia vulgaris.
mummification	<B>(ש"ע)</B> חניטה, התחנטות.
mummify	<B>(פ')</B> לחנוט.
mumming play	<B>(ש"ע)</B> משחקי תעלול או ממתק.
mummy	<B>(ש"ע)</B> מומיה, חנוט, גופה חנוטה.
muse	<B>(ש"ע)</B> מוזה. אחד מתשע אלות האומנויות העתיקות ביוון.
musk	<B>(ש"ע)</B> חומר רחיף שמפריש המושק הזכר, יונק מעלה גרה. משמש לריפוי ולשיקויי קסם.
myromancy	<B>(ש"ע)</B> נחש שרירים (שיטת הגדת עתידות על פי תנועת שרירים).
myrrh	<B>(ש"ע)</B> מור. צמח בושם המשמש לקטורת ובשיקויי אהבה ותשוקה. שמו הלטיני Commiphora myrrha.
myrrhol	<B>(ש"ע)</B> שמן המור.
myrtle	<B>(ש"ע)</B> הדס. שיח ממשפחת ההדסיים, המשמש בשיקויי אהבה. בימי הביניים נהגו נערים מאוהבים למשוח את גופם בשמן הדס כדי למשוך את תשומת לב הנערות. זרי הדס ושושנים הם זרים מסורתיים בטקסי חתונה. שמו הלטיני של הצמח: Myrtus communis.
mystagogue	<B>(ש"ע)</B> מורה תורת המסתורין.
mystagogy	<B>(ש"ע)</B> תורת המסתורין.
mystery	<B>(ש"ע)</B> מסתורין.
mystic	<B>(ש"ע)</B> בעל סוד, בקי בחוכמת הנסתר.
mystical	<B>(ש"ת)</B> מיסטי, מסתורי.
mysticism	<B>(ש"ע)</B> מיסטיות, תורת הסוד, תורת הנסתר.
myth	<B>(ש"ע)</B> מיתוס.
mythic|mythical	<B>(ש"ת)</B> מיתי.
mythogenesis	<B>(ש"ע)</B> יצירת מיתוס.
mythological	<B>(ש"ת)</B> מיתולוגי.
mythologist	<B>(ש"ע)</B> מיתולוג, חוקר מיתולוגיה.
mythology	<B>(ש"ע) </B>מיתולוגיה.
mythopoet	<B>(ש"ע)</B> משורר מיתולוגיה.
mythopoetic	<B>(ש"ע)</B> יוצר אגדות.
mythopoetry	<B>(ש"ע)</B> שירה מיתולוגית.
naiad	<B>(ש"ע)</B> נאידה. נימפת מים במיתולוגיה היוונית.
names|name|word|words	<B>(ש"ע)</B> שמות. במאגיה, מילים בעלות כוח אלוהי לחולל שינויים.
names of power|name of power|word of power|words of power	<B>(ש"ע)</B> שמות כח. במאגיה, מילים בעלות כוח אלוהי לחולל שינויים.
nard	<B>(ש"ע)</B> נרד.<BR>צמח בושם המשמש להפקת שמן וקטורת מאגיים. שמו הלטיני Nardostachys jatamansi.
natal chart	<B>(ש"ע)</B> מפת לידה אסטרולוגית.
natural magic	<B>(ש"ע)</B> כשף טבעי, כשפים טבעיים.
nature	<B>(ש"ע)</B> טבע, יקום, בריאה, מקור חיים. בדתות פגניות חדשות: זהה עם האלוהות ומגלם את האלוהות.
nature deities|nature gods	<B>(ש"ע)</B> כוחות הטבע, אלי הטבע.
nature spirit	<B>(ש"ע)</B> רוח טבע.
nature worship	<B>(ש"ע)</B> פולחן הטבע.
necrolatry	<B>(ש"ע)</B> פולחן מתים.
necromancer	<B>(ש"ע)</B> דורש אל המתים, בעל אוב, נקרומנסר.
necromancy	<B>(ש"ע)</B> אובות, דרישה אל המתים, נקרומנסיה.
necropolis	<B>(ש"ע)</B> נקרופוליס, קרית מתים, בית קברות.
nectar	<B>(ש"ע)</B> נקטר. משקה האלים האולימפיים במיתולוגיה היוונית.
neo pagan|neo-pagan|new pagan	<B>(ש"ע)</B> פגני חדש. מונח המתאר מאמין באחת מן הדתות הפגניות החדשות, בין אם דת חידוש, בין אם דת קוממיות.
neophyte	<B>(ש"ע)</B> טירון. כינוי לאדם המתחיל את צעדיו במאגיה, במיוחד מאגיה טקסית או חברות באחד מן המסדרים המיסטיים הסודיים.
nereid	<B>(ש"ע)</B> נראידה.
netherworld|nether world	<B>(ש"ע)</B> העולם התחתון, שאול תחתיות.
nettle	<B>(ש"ע)</B> סרפד צורב. <BR>עשב בר שעיר הגורם לגירויים בעור. אחד מתשעת הצמחים המרפאים של המיתולוגיה האנגלו סקסית. מקודש לאל הרעמים הצפוני תור. על פי האמונה העממית, מעודד אומץ לב ומגן מפני ברקים. שמו הלטיני Urtica urens.
new moon	<B>(ש"ע)</B> ירח חדש, מולד הירח, מולד הלבנה, הירח במולדו.
new year	<B>(ש"ע)</B> ראש השנה, השנה החדשה.
night owl	<B>(ש"ע)</B> לילית. ציפור טרף לילית.
nightingale	<B>(ש"ע)</B> זמיר.
nightmare	<B>(ש"ע)</B> סיוט, חלום בלהה, חלום בלהות, בעת לילה.
nightshade	<B>(ש"ע)</B> הסולנום השחור. צמח רעיל מסוג סולנום ממשפחת הסולניים.
nixie	<B>(ש"ע)</B> ניקסי. בתולת מים.
nocturnal	<B>(ש"ע)</B> לילי, נוקטורן, חזיון לילה, מחזה לילה.
nordic	<B>(ש"ת)</B> נורדי, בן העמים הגרמניים בצפון אירופי, סקנדינבי.
norns	<B>(ש"ע)</B> הנורנות.
norseman	<B>(ש"ע)</B> סקנדינבי, בן הצפון.
north star	<B>(ש"ע)</B> כוכב הצפון, כוכב הציר הצפוני.
northern lights	<B>(ש"ע)</B> זהר הצפון, הזהר הצפוני, הנגה הצפוני.
northland	<B>(ש"ע)</B> החבל הצפוני, סקנדינביה.
nosce te ipsum	<B>(ש"ע)</B> לטינית: דע את עצמך. <BR>חלק מן המקור הרעיוני לחוק תלמה של אליסטייר קראולי, הגורס, כי על האדם לגלות מהו רצונו האמיתי ולפעול אך ורק להשגת רצון זה.
november	<B>(ש"ע)</B> נובמבר, החודש הרומאי התשיעי, החודש האחד עשר.
numerology	<B>(ש"ע)</B> נומרולוגיה.
nundine	<B>(ש"ע)</B> נונדינה. יום השוק ברומא העתיקה.
nut|nettle	<B>(ש"ע)</B> אגוז.
nutmeg	<B>(ש"ע)</B> אגוז מוסקט. <BR>תבלין המשמש בתרכובות קטורת מאגיות. אפרודיזיאק ומרכיב בשיקויי אהבה לנשים. שמו הלטיני Myristica fragrans.
nymph	<B>(ש"ע)</B> נימפה.
nympholepsy	<B>(ש"ע)</B> נימפולפסיה, שגעון הנימפות, טירוף הנימפות.
oak	<B>(ש"ע)</B> אלון. אחד העצים החשובים ביותר מבחינה תיאולוגית. מקודש לאלת הפריון הכנענית אשרה. העץ הקדוש ביותר לקלטים, נחשב עץ הדרואידים. עץ החודש השביעי בלוח העצים הקלטי: 10 יוני - 7 יולי. בתרבות הקלטית מסמל את הקיץ ואת החצי המתמלא של השנה. עץ יול בתרבות האירופית בדרך כלל היה עץ אלון (במקרים אחרים עץ אשוח). בתרבות הנורדית מקודש לאל הרעם תור ומייצג את נשמות המתים.
oak apple	<B>(ש"ע)</B> תפוח אלון, עפץ, בלוט.
oak gall	<B>(ש"ע)</B> בלוט, עפץ.
oath	<B>(ש"ע)</B> שבועה.
oath of allegiance	<B>(ש"ע)</B> שבועת אמונים.
oathbound	מוגן בשבועת הסודיות.
oathbreaker	<B>(ש"ע)</B> מפר שבועות. בוגד בשבועת האמונים הסודית לויקה המסורתית.<BR>
obelisk	<B>(ש"ע)</B> אובליסק, חדודית, חירה, אובלוס.
obsidian	<B>(ש"ע)</B> אובסידיאן (סוג אבן טובה).
occult	<B>(ש"ת)</B> נסתר, כמוס, סודי, טמיר, מסתורי.
occult sciences	<B>(ש"ע)</B> תודת הסוד, מדעי סתר, חכמת הנסתר.
occultism	<B>(ש"ע)</B> תורת הסוד, חכמת הנסתר.
occultist	<B>(ש"ע)</B> עוסק בתורת הסוד, בקי בחכמת הנסתר.
oceanid	<B>(ש"ע)</B> אוקיינוסית.
of old	<B>(ש"ע)</B> מימים עברו.
offering	<B>(ש"ע) </B>מנחה.
ogham	<B>(ש"ע)</B> אוגם. האלף בית הקלטי. כולל עשרים פיוז או אותיות המייצגות עצים.
ogre	<B>(ש"ע)</B> אוגר.
ogress	<B>(ש"ע)</B> אוגרה.
oil	<B>(ש"ע)</B> שמן.
ointment	<B>(ש"ע)</B> משחה.
olive	<B>(ש"ע)</B> זית, עץ הזית. עץ המשמש להפקת השמן המהווה בסיס לכל השמנים המאגיים.
olive oil	<B>(ש"ע)</B> שמן זית. בפולקלור, במאגיה ובריפוי עממי: שמן הבסיס המסורתי.
olivine|peridot	<B>(ש"ע)</B> אוליוין, פרידות, זיתין, אבן הזהב.
omen	<B>(ש"ע)</B> אות, סימן, סימן לבאות.
omens of evil portent	<B>(ש"ע)</B> סימנים מבשרי רע.
ominous	<B>(ש"ע)</B> מבשר רע, סימן רע.
oneirocritic|oneirocritical|oneirologist	<B>(ש"ע)</B> פותר חלומות, בקי בפתרון חלומות.<HR><B>(ש"ת)</B> של פתרון חלומות.
oneirocriticism	<B>(ש"ע)</B> פתרון חלומות, פירוש חלומות.
oneiromancy	<B>(ש"ע)</B> נחש חלומות (שיטת הגדת עתידות)
onion	<B>(ש"ע)</B> בצל הגינה. <BR>פקעת אכילה, המשמשת כצמח רב עוצמה להגנה במאגיה ובפולקלור. חשוב ברפואה העממית, בעיקר לחיטוי פצעים.
onomanacy	<B>(ש"ע)</B> נחש אותיות (שיטת הגדת עתידות על פי אותיות שמו של האדם).
onyx	<B>(ש"ע)</B> אוניקס, שהם, אנך (סוג אבן טובה).
oomancy	<B>(ש"ע)</B> נחש ביצים (שיטת הגדת עתידות).
opal	<B>(ש"ע)</B> אופל, לשם (סוג אבן טובה).
opening of the mouth	<B>(ש"ע)</B> פתיחת הפה. טקס מצרי שמטרתו להעניק רוח חיים למת.
opening ritual	<B>(ש"ע)</B> טקס הפתיחה.
ophiolater|ophite	<B>(ש"ע)</B> עובד נחשים.
ophiolatry	<B>(ש"ע)</B> פולחן נחשים.
ophiomancy	<B>(ש"ע)</B> נחש נחשים (שיטת הגדת עתידות על פי תנועת נחשים).
oracle	<B>(ש"ע)</B> אורים ותומים, אורקל. נביא וחוזה באמצעות תקשור וקשרים עם האלים.
oracular	<B>(ש"ע)</B> נבואי, מנבא, של אורים ותומים.
orchid	<B>(ש"ע)</B> סחלב.
ornithormancy	<B>(ש"ע)</B> טיר, אורניתומנסיה, נחש עופות (שיטת הגדת עתידות).
orpine|live-forever|livelong|orpin	<B>(ש"ע)</B> צורית.<BR>צמח המקודש בתרבות הנורדית. משמש להגדת עתידות אהבה בליל היפוך הקיץ. שמו הלטיני Sedum telephium.
out of body experience|OBE	<B>(ש"ע)</B> חוויה חוץ גופית. מונח המתאר מסע אסטרלי.
out-of-body travel|out of body travel	<B>(ש"ע)</B> מסע חוץ גופי.
overlook	<B>(פ')</B> לתת עין הרע.
overlooking	<B>(ש"ע)</B> נתינת עין הרע.
owl	<B>(ש"ע)</B> לילית, כוס, ינשוף.
oyster	<B>(ש"ע)</B> צדפה. שימשה כמאכל מעורר תשוקה (אפרודיזיאק) ברומא העתיקה.
paeony	<B>(ש"ע)</B> אדמונית החורש.<BR>נקרא גם אדמון. צמח בעל פרחים ורודים אדומים. בפולקלור של המזרח הרחוק נחשב לצמח מושך אהבה, שביכולתו לברך נערה צעירה בחתן ראוי. שמו הלטיני Paeonia mascula.
pagan	<B>(ת')</B> פגני.
pagandom	<B>(ש"ע)</B> ארץ פגנית. מונח המתאר אזור המיושב בעיקר על ידי מאמינים פגניים.
paganish	<B>(ש"ת)</B> פגני, כדרך הפגנים.
paganism	פגניות.
paganize	<B>(פ')</B> עשה פגני, העשה פגני.
palladian	<B>(ש"ע)</B> של פלס, אלת החוכמה היוונית פלס אתנה.
pallomancy	<B>(ש"ע)</B> נחש מטוטלת (שיטת הגדת עתידות).
palm	<B>(ש"ע)</B> דקל, תמר. עץ המקודש לאלה הכנענית אשרה ולאלת הקרתגית תנית. נקרא "עץ חיים", מושג המשמש שם נרדף לאלות לאלות הללו.
palmist	<B>(ש"ע)</B> קורא בכף היד.
palmistry	<B>(ש"ע)</B> חכמת היד, קריאה בכף היד.
pandean	<B>(ש"ת)</B> של האל פן.
panpipe|pan pipe	<B>(ש"ע)</B> חליל רועים עתיק, עשוי קנים. על פי המיתולוגיה היוונית, המציאו אל הרועים פן.
pantheism	<B>(ש"ע)</B> פנתיאזם. האמונה כי האלוהות והטבע הם אחד.
pantheist	<B>(ש"ע)</B> פנתאיסט.
pantheistic	<B>(ש"ת)</B> פנתיאיסטי.
papyrus	<B>(ש"ע)</B> פפירוס, גומא, גליון פפירוס, כתב יד.
parnassian	<B>(ש"ת)</B> פרנסי, של ההר פרנסוס.
parsee|parsi	<B>(ש"ע)</B> פרסי, אמגוש.
parsley|petroseline	<B>(ש"ע)</B> פטרוזיליה, פסרוסלינון, כרפס.<BR>צמח תבלין המקודש לאלים הגרמאניים וודן והולה, מנהיגי הציד הפראי.
passion fruit|passion flower	<B>(ש"ע) </B>שעונית, פסיפלורה.<BR>פרי התשוקה, פרח התשוקה. צמח המשמש במאגיה וברפואה העממית. בפולקלור נחשב צמח אהבה מובהק. שמו הלטיני Passiflora incarnata.
past life regression	<B>(ש"ע)</B> רגרסיית גלגולים קודמים. טכניקה היפנוטית שמטרתה להזכיר לאדם הנמצא בטראנס אירועים מגלגולים קודמים.
patchouli	<B>(ש"ע)</B> פצ'ולי, פטצ'ולי.<BR>צמח המשמש להפקת קטורת בעלת מאפייני טיהור וגירוש. שמו הלטיני Pogostemon patchouli.
path	<B>(ש"ע)</B> נתיב, דרך, מסורת.
pathfinder	<B>(ש"ע)</B> מורה דרך. בויקה ובמאגיה, מדריך רוחני או כלי רוחני.
pathworking	<B>(ש"ע)</B> ניתוב.
patron	<B>(ש"ע)</B> פטרון, מגן, תומך, חסדאי, פטריצי.
paynim	<B>(ש"ע)</B> פגני, כינוי גנאי לפגני, עובד אלילים.
peace pipe|pipe of peace	<B>(ש"ע)</B> מקטרת השלום.
pearl	<B>(ש"ע)</B> פנינה, מרגלית.
pekhret	<B>(ש"ע)</B> פחרת. מרשמים מאגיים רפואיים במצרים העתיקה.
pellar	<B>(ש"ע)</B> פלאר. באנגליה, מגיד עתידות, מתיר קללות ומרפא.
pendulum	<B>(ש"ע)</B> מטוטלת. כלי המשמש בנחש ובהגדת עתידות.
pennyroyal	<B>(ש"ע)</B> נענת הכדורים.<BR>נקרא גם חבק, פודנג, פוטנק. צמח המשמש במאגיה וברפואה העממית. נחשב לצמח טיהור, הגנה ואהבה. שמו הלטיני Mentha pulegium.
pentacle	<B>(ש"ע)</B> פנטכל, דיסקת הכוכב המחומש.
pentagram	<B>(ש"ע)</B> פנטגרם, פנטגרם, כוכב מחומש, כוכב שלמה.
peony	<B>(ש"ע)</B> אדמונית. סוג עשבי חורש רב שנתיים ממשפחת הנוריתיים, בעלי שורש עבה ופרחים גדולים.
pepper	<B>(ש"ע)</B> פלפל, פלפלת, פלפלון. צמח המשמש במאגיה וברפואה העממית. בעל מאפייני גירוש וכפיתה.
peppermint	<B>(ש"ע)</B> נענת הכדורים.<BR>נקרא גם מנתה, נענע, נענה, פפרמינט. צמח המשמש במאגיה וברפואה העממית. נחשב לצמח טיהור, הגנה ואהבה. שמו הלטיני Mentha piperita.<BR>
perform wonders	<B>(פ')</B> לחולל נפלאות.
perfume	<B>(ש"ע)</B> בושם. בפולחן הפגני, בפולקלור, במאגיה, וברפואה העממית, חומר צמחי בעל ניחוח נעים המשמש כמנחה לאלים, לגירוש רוחות רעות ולטיפול במחלות.
periapt	<B>(ש"ע)</B> קמע, סגולה.
petrified wood	<B>(ש"ע)</B> פטריפייד ווד, עץ מאובן.
phallicism	<B>(ש"ע)</B> פולחן האיבר, פולחן הפאלוס.
phallicist	<B>(ש"ע)</B> דוגל בפולחן האיבר, מאמין בפולחן הפאלוס.
phallus	<B>(ש"ע)</B> פאלוס, איבר המין הזכרי.
phantasmal|phantasmic	<B>(ש"ת)</B> תעתועי, של חזיון שוא.
phantom	<B>(ש"ע)</B> פנטום.
phases of the moon	<B>(ש"ע)</B> מופעי הירח, צורות הלבנה.
philistine	<B>(ש"ת)</B> פלשתי.
philosophers' stone|lapis philosophorum|philoposhers stone|sorcerers stone|sorcerers' stone	<B>(ש"ע)</B> אבן החכמים, אבן הפילוסופים. באלכימיה: אבן שביכולתה להפוך מתכות בסיסיות לזהב.
philtre|philter	<B>(ש"ע)</B> פילטר, שיקוי אהבה.
phoenician	<B>(ש"ת)</B> פניקי, פיניקי, צורי, צידוני.<BR><B>(ש"ע) </B>השפה הפניקית.
phoenix	<B>(ש"ע)</B> פניקס, עוף החול.
phratry	<B>(ש"ע)</B> פרטריה, מטה, חלק משבט ביוון העתיקה.
phrygian	<B>(ש"ת)</B> פריגי<BR><B>(ש"ע) </B>השפה הפריגית.
phyle	<B>(ש"ע)</B> פילי. שבט באתונה העתיקה.
phythoness	<B>(ש"ע)</B> פיתוניה. כהנת לאפולו ביוון העתיקה.
phytonic	<B>(ש"ע) </B>פיתוני, נבואי, מנבא.
pimpernel	<B>(ש"ע)</B> מרגנית.
pin	<B>(ש"ע)</B> סיכה, פריפה.
pine	<B>(ש"ע)</B> אורן.
pine cone	<B>(ש"ע)</B> אצטרובל.
pine needle	<B>(ש"ע)</B> מחט האורן.
pine nut	<B>(ש"ע)</B> צנובר. מאכל מעורר תשוקה (אפרודיזיאק). מרכיב חשוב בשיקויי אהבה רבים. מתכון אהבה עתיק כולל צנוברים, פקעות סחלבים, ארוגולה ופיסטוקים.
pistacia|terebinth	<B>(ש"ע)</B> אלה ארצישראלית. <BR>נקרא גם בטם, בטמה, אילון. עץ המקודש לאלת הפריון הכנענית הגדולה. ככל הנראה האשרה, מזבח העץ לאלת הפריון, היה עשוי מעץ זה. שמו הלטיני Pistacia palestina.
plane	<B>(ש"ע)</B> מישור.
planet	<B>(ש"ע)</B> כוכב לכת, כוכב מזל, גרם שמים.
planetary	<B>(ש"ת)</B> של כוכב לכת, נתון להשפעת כוכב לכת.
planetstricken	<B>(ש"ע)</B> מקולל על ידי הכוכבים, אחוז בהלה.
plant	<B>(ש"ע)</B> צמח.
plantain	<B>(ש"ע)</B> לחך גדול.<BR>צמח המשמש במאגיה וברפואה העממית. שמו הלטיני Plantago major.
plebian	<B>(ש"ע)</B> פלבאי, ממעמד העם הפשוט באתונה העתיקה.
pointing	<B>(ש"ע)</B> הוראה באצבע.
poison	<B>(ש"ע)</B> רעל, סם מוות, ארס.
poison dogwood|poison elder|poison oak|poison sumac	<B>(ש"ע)</B> שיח גבוה ממשפחת האלתיים, ארסי למגע ולמאכל. פריו קטן עגול וירקרק.
poison ivy	<B>(ש"ע)</B> רוש עקוד. צמח רב שנתי ארסי ממשפחת הסוככיים, בעל פרחים לבנים.
poisoning	<B>(ש"ע)</B> הרעלה.
poisounous	<B>(ש"ת)</B> מרעיל, רעיל, ארסי.
pole	<B>(ש"ע)</B> מוט, תורן, עמוד. בפולקלור ובמאגיה, סמל גבריות ופריון.
pole riding	<B>(ש"ע)</B> רכיבת מוט. מנהג נפוץ בטקסי פריון פגניים.
poltergeist	<B>(ש"ע)</B> פולטרגייסט, שד הרעש.
polytheism	<B>(ש"ע)</B> פוליתאיזם, פוליתיאסם, ריבוי אלים, אמונה באלים רבים.
polytheist	<B>(ש"ע)</B> פוליתאיסט, מאמין באלים רבים.
polytheistic	<B>(ש"ת)</B> פוליתיאסטי, של אמונה באלים רבים.
pomegranate	<B>(ש"ע)</B> רימון. סמל פריון ושפע, קשור לאלה היוונית פרספונה.
pooka|puck|puka	<B>(ש"ע)</B> פוקה. שם אחר לבוגי.
poplar	<B>(ש"ע)</B> צפצפה רעדנית. <BR>עץ נוי ממשפחת הערבתיים, משמש במאגיה וברפואה העממית.
poppet	<B>(ש"ע)</B> פופט. בכשף זיקה ובריפוי: בובת דמות המייצגת אדם מסוים.
poppy	<B>(ש"ע)</B> פרג. פרח בעל עלי כותרת אדומים. פריחתו מסמלת את דם האל אדוניס.
poppy seed	<B>(ש"ע)</B> זרעוני פרג.
portent	<B>(ש"ע)</B> סימן מבשר רע, אות, סימן לבאות.
portentous	<B>(ש"ת)</B> מבשר רע, מנבא רע.
posessed	<B>(ש"ת)</B> אחוז דיבוק, שכפאו שד.
posession	<B>(ש"ע)</B> דיבוק.
potion	<B>(ש"ע)</B> שיקוי.
powwow	<B>(ש"ע)</B> פואו-או. שיטת כישוף עממית של המהגרים הגרמנים למדינת פנסילבניה בארצות הברית, שהביאו עמם מסורת של מאגיה בעלת מאפיינים גרמאנים, רומאים ונוצריים ליבשת החדשה.
practical magic	<B>(ש"ע)</B> כשף מעשי.
praetor	<B>(ש"ע)</B> פרטור, שופט ברומא העתיקה, דרגתו אחת מתחת לקונסול.
praetorian	<B>(ש"ע)</B> פרטורי. שומרי המלך ברומא העתיקה.
prayer	<B>(ש"ע)</B> תפילה.
prayer book	<B>(ש"ע)</B> ספר תפילה.
precious stone	<B>(ש"ע)</B> אבן יקרה, אבן טובה.
predecessor	<B>(ש"ע)</B> אב קדמון.
prediction	<B>(ש"ע)</B> תחזית, נבואה.
predictor	<B>(ש"ע)</B> מנבא, נביא.
prehistory	<B>(ש"ע)</B> פרה היסטוריה, קדם היסטוריה.
prehnite	<B>(ש"ע)</B> פרהנייט (סוג אבן טובה). נקראת על שם הקולונל ההולנדי הנדריק פון פרהן שגילה אותה בדרום אפריקה בשנת.
preparation	<B>(ש"ע)</B> תכשיר, תרקיח.
priest	<B>(ש"ע)</B> כהן. תואר למכשף ויקני בדרגה שניה ומעלה, שאינו מסייע בהובלת אסיפה או מעגל.
priestess	<B>(ש"ע)</B> כהנת. תואר למכשפה ויקנית בדרגה שניה ומעלה, שאינה מובילה אסיפה או מעגל.
priesthood	<B>(ש"ע)</B> כהונה.
primrose	<B>(ש"ע)</B> רקפת.<HR><B>(ש"ע) </B>בכור אביב מצוי.<HR><B>(ש"ע)</B> נר הלילה.
prince of darkness	<B>(ש"ע)</B> אל השאול.
proconsul	<B>(ש"ע)</B> פרוקונסול. מושל או שר צבא ברומא העתיקה.
procurator	<B>(ש"ע)</B> פרוקרטור. פקד המשק של מחוז ברומא העתיקה.
projective hand	<B>(ש"ע) </B>היד המטילה. במאגיה ובפולקלור, כינוי ליד הדומיננטית באדם, המשמשת להטלת כשפים.<BR>
prophecy	<B>(ש"ע)</B> נבואה.
prophet	<B>(ש"ע)</B> נביא. בתיאולוגיה ובמאגיה, אדם המקבל מידע, השראה ורעיונות אודות העתיד ממקור אלוהי.
prophetess	<B>(ש"ע)</B> נביאה.
prophethood	<B>(ש"ע)</B> נביאות.
protecting magic|protective magic	<B>(ש"ע)</B> כשף הגנה.
protective hand	<B>(ש"ע)</B> היד המגוננת. במאגיה, היד הכותבת של האדם. נחשבת ליד שבאמצעותה יש להטיל את הכשפים.
psyche	<B>(ש"ע)</B> פסיכה.<HR><B>(ש"ע) </B>פסיכה, הנשמה, נפש האדם.
psychic	<B>(ש"ע)</B> פסיכי, נפשי, רוחני.
psychic attack	<B>(ש"ע)</B> מתקפה פסיכית.
psychic defence	<B>(ש"ע)</B> התגוננות פסיכית.
psychic mind	<B>(ש"ע)</B> הנפש הפסיכית. במאגיה, כינוי לתת מודע, החלק שבאמצעותו ניתן להיכנס אל המישור האסטרלי.
psychomancy	<B>(ש"ע)</B> נחש נשמות, פסיכומנטיה (שיטת הגדת עתידו על פי התייעצות עם הנשמה).
pumpkin	<B>(ש"ע)</B> דלעת.
punic	<B>(ש"ת)</B> פוני, של קרתגו, של קרתגה, קרתגי.<BR><B>(ש"ע) </B>השפה הפונית.
purification	<B>(ש"ע)</B> טיהור, טהרה, זיכוך.
purify	<B>(פ')</B> לטהר, לזכך, לנקה, להיטהר.
purple	<B>(ש"ע)</B> סגול. בפולקלור ובהסטוריה, צבע מלוכה ושלטון.
put an oath	<B>(פ')</B> להשביע.
pyramid	<B>(ש"ע)</B> פירמידה.
pyrite	<B>(ש"ע)</B> פיריט, פירית, אבן האש.
pyromancy	<B>(ש"ע)</B> פירומנסיה, נחש אש (שיטת הגדת עתידות).
pyrrhic	<B>(ש"ע)</B> פיריך. מחול מלחמתי ביוון העתיקה.
pyschic awareness	<B>(ש"ע)</B> מודעות פסיכית. מצב מודעות פתוח למישור הרוחני.
pythia	<B>(ש"ע)</B> פיתיה. הכהנת הגדולה לאפולו בדלפי.
pythiad	<B>(ש"ע)</B> פיתיאדה. ביוון העתיקה, תקופה של ארבע שנים בין החגיגות האולימפיות.
pythian|pythic	<B>(ש"ע)</B> פיתי, של הפיתיה, של אפולו, של הפיתיאדה.
pyxis	<B>(ש"ע)</B> פיקסיס. ביוון העתיקה, מין אגרטל עם מכסה.
quarter days	<B>(ש"ע)</B> ימי הרבעים. מונח קלטי המתאר את שני ימי השוויון ושני ימי ההיפוך מתוך שמונת חגי השמש הפגניים. בתרבות הקלטית נחשבו אלו לחגים הפחות חשובים בגלגל השנה.
quarters|the quarters	<B>(ש"ע)</B> ארבע רוחות השמים, המסומנות במעגל ובמאגיה בארבעת היסודות.
quarz	<B>(ש"ע)</B> קוורץ. מחצב גבישי שקוף. משמש לטיהור, לחידוש אנרגיות מאגיות ולהטענת אבנים וקריסטלים.
queen of heaven	<B>(ש"ע)</B> מלכת השמים.
queen of hell	<B>(ש"ע)</B> מלכת השאול.
queen of love	<B>(ש"ע)</B> אפרודיטה.
quill of cinnamon	<B>(ש"ע)</B> קנה קינמון.
quirin|quirus	<B>(ש"ע)</B> קווירין, קווירוס. באמונה העממית, אבן שבכוחה לגלות את האמת.
rabbit's foot|rabbit foot	<B>(ש"ע)</B> קמע רגל ארנבת.
raise	<B>(פ')</B> לעורר.
raise the dead	<B>(פ')</B> לעורר את המתים.
ram	<B>(ש"ע)</B> אייל.
raspberry	<B>(ש"ע)</B> פטל.
read dreams	<B>(פ')</B> לפתור חלומות, לפרש חלומות.
rebirth	<B>(ש"ע)</B> לידה מחדש.
receptive hand	<B>(ש"ע) </B>היד המקבלת. במאגיה ובפולקלור, כינוי ליד הלא דומיננטית באדם, שלא תצלח להטלת כשפים, אך מתאימה לקבלת כוח מאגי חיצוני.
recon|reconstructionist	<B>(ש"ע)</B> מאמין באחת מדתות הקוממיות הפגניות החדשות.<BR>
reconstructionism	<B>(ש"ע)</B> קוממיות. תנועה של חידוש דתות פגניות ככתבן וכלשונן, תוך התאמה לנסיבות החיים המודרניים.
reed	<B>(ש"ע)</B> קנה מצוי. <BR>נקרא גם אגם, אגמון. עץ החודש השנים עשר בלוח העצים הקלטי: 28 אוקטובר - 24 נובמבר. בעל חשיבות בטקסי הטיהור הרומאיים. שמו הלטיני Phragmites communis.
reincarnation	<B>(ש"ע)</B> גלגול נשמות. בתיאולוגיה, לידה מחדש של נשמת המת בגוף אחר.
remedy	<B>(ש"ע)</B> רפואה, תרופה, סם, מרפא.
requiem	<B>(ש"ע)</B> רקוויאם, טקס אשכבה.
resin	<B>(ש"ע)</B> שרף.
revelation	<B>(ש"ע)</B> התגלות.
revival	<B>(ש"ע)</B> תחייה.
revival of ancient customs	<B>(ש"ע)</B> חידוש מנהגים קדומים.
rhabdomancy	<B>(ש"ע)</B> נחש מטה (שיטת הגדת עתידות).
rhodochrosite	<B>(ש"ע)</B> רודוכרוזיט, רודוכרוסיט (סוג אבן טובה).
rhodonite	<B>(ש"ע)</B> רודוניט (סוג אבן טובה המורכבת מסילקט המנגניון).
rhyme	<B>(ש"ע)</B> חרוז.
ring	<B>(ש"ע)</B> טבעת. בפולקלור סמל לקשר עסקי או אישי מחייב.<BR>
rise again	<B>(ש"ע)</B> לקום לתחייה.
rite	<B>(ש"ע)</B> פולחן, טקס.
robe	<B>(ש"ע)</B> גלימה.
rock crystal	<B>(ש"ע)</B> קריסטל הרים, קוורץ.
rocket|arugula	<B>(ש"ע)</B> רוקט, מעריב, קורה, ארוגולה. צמח תבלין המשמש במאגיה וברפואה העממית כצמח הגנה. ידוע גם בתור אפרודיזיאק. מתכון עתיק לתבשיל מעורר תשוקה כולל ארוגולה, פקעות סחלב, פיסטוקים וצנוברים. שמו הלטיני Hesperis matronalis.
rose	<B>(ש"ע)</B> ורד. בפולקלור ובמאגיה: מלך הפרחים וסמל אהבה, ידידות ורגשות. מקודש לאלה הגרמאנית הולה ולמלך הדוורפים, דמות במיתולוגיה הנורדית.
rose water	<B>(ש"ע)</B> מי ורדים.
rosemary	<B>(ש"ע)</B> רוזמרין רפואי. <BR>שיח נוי ממשפחת השפתניים. בפולקלור ובמאגיה: סמל נצח, אריכות ימים וזכרון עולם. בתרבות הגרמאנית והנורדית נחשב צמח עלפים, לאחר שהובא לאזור על ידי הרומאים. נקרא גם כליל ההר. שמו הלטיני Rosmarinus officinalis.
rosequarz	<B>(ש"ע)</B> רוזקוורץ (סוג אבן טובה). בפולקלור ובמאגיה משמשת לריפוי כוויות רגשיות ולחיזוק אהבה עצמית וקשרי אהבה.
round table	<B>(ש"ע)</B> השולחן העגול. במיתולוגיה הארתורית, שולחן המלך ארתור.
rowan	<B>(ש"ע)</B> חוזרר. עץ החודש השני בלוח העצים הקלטי: 21 ינואר - 17 פברואר.
ruby	<B>(ש"ע)</B> רובי, אודם (סוג אבן טובה). בפולקלור ובמאגיה: סמל פריון, רחם, דם הרחם ונשיות.
rue	<B>(ש"ע)</B> פיגם מצוי.<BR>נקרא גם רודה, רוטה. עשב חריף ממשפחת הפיגמיים. בפולקלור ובמאגיה נחשב לבעל סגולות הגנה מן המעלה הראשונה. משמש גם למשחות תעופה ולמרקחות כישוף. שמו הלטיני Ruta graveolens.
rune	<B>(ש"ע)</B> רונה, אות באלפבית הסקנדינבי העתיק או באלף בית הסקסוני העתיק.<HR><B>(ש"ע)</B> בהשאלה: סמל מאגי, מלת קסם
rune stones	<B>(ש"ע)</B> אבני רונות. אבנים שעליהן חרוטות רונות. משמשות להגדת עתידות.
runic	<B>(ש"ע)</B> רוני, כתוב באלפבית הסקנדינבי העתיק, של הרונות.
rush	<B>(ש"ע)</B> אגמון, קנה סוף.
rw	<B>(ש"ע)</B> ראו. טקסט קדוש במצרים העתיקה.
sabbat|sabbath	<B>(ש"ע)</B> שבת, שבתו, סבאת. חגיגה של אחד משמונת חגי השמש בגלגל השנה הפגני.<BR><B>(ש"ע)</B> בהשאלה: חג, חגיגה, התכנסות פולחן, כינוס מכשפות.
sabine	<B>(ש"ת)</B> סביני, בן לשבט אפניני עתיק שנכבש על ידי הרומאים.
sachet	<B>(ש"ע)</B> שקיק בושם.
sacral	<B>(ש"ת)</B> דתי, פולחני.
sacred	<B>(ש"ת)</B> קדוש, מקודש.
sacrifice	<B>(ש"ע)</B> קרבן, זבח, מנחה.
sacrificial mating	<B>(ש"ע)</B> הזדווגות קרבן. איחוד האל והאלה לפני מות האל בעונה הלא פוריה וירידתו לשאול.
saffron|azafran|crocus|saafron	<B>(ש"ע)</B> זעפרן.<BR>נקרא גם כרכום. צמח תבלין צהוב יקר ערך, המסמל בפולקלור ובמאגיה עושר ושפע. אפרודיזיאק ומשמש בשיקויי אהבה ובייחוד בשיקויי נישואין. שמו הלטיני Crocus sativus.
sage|salvia|sauja|sawge	<B>(ש"ע)</B> מרווה רפואית. <BR>עשב בעל ניחוח חרפרף ממשפחת השפתניים. שמו הלטיני Salvia officinalis. בפולקלור ובמאגיה סמל שגשוג כלכלי, אריכות ימים ואלמוות. משמשת גם לטיהור.
salamander	<B>(ש"ע)</B> סלמנדרה. במיתולוגיה הקלאסית, לטאה פלאית החיה באש ומייצגת את רוח יסוד האש.
salt	<B>(ש"ע)</B> מלח. בפולקלור ובמאגיה, מייצג את יסוד האדמה ומשמש לטיהור ולגירוש.
salve	<B>(ש"ע)</B> משחת ריפוי. בפולקלור וברפואה העממית, חומר סמיך שרוקחים מצמחים למטרה רפואית.
samhain	<B>(ש"ע)</B> סו ויין, סמהין, חג המתים. אחד משמונת חגי השמש בגלגל השנה הפגני. נחגג בתאריך 31 לאוקטובר.
sanctification	<B>(ש"ע)</B> קידוש, הקדשה.
sanctuary	<B>(ש"ע)</B> מקום קדוש, מקדש באויר הפתוח.
sanctum	<B>(ש"ע)</B> מקדש.
sanctum sanctorum	<B>(ש"ע)</B> קדש הקדשים.
sandalwood	<B>(ש"ע)</B> סנדלווד, עץ סנדל, עץ האלמוג. צמח המשמש להפקת שמן וקטורת מאגיים, עם מאפייני טיהור מן המעלה הראשונה.
sapphire	<B>(ש"ע)</B> ספיר (סוג אבן טובה).
sard|sardius	<B>(ש"ע)</B> אבן סרדית, סרדיוס. סוג אבן טובה. נקראת של שם סרדיס, בירת לידיה העתיקה. שמה המודרני הוא קרניאולין.<BR>
sardonyx	<B>(ש"ע)</B> סרדוניקס, שהם אדומה (סוג אבן טובה).
sator|rotas|sator rotas	<B>(ש"ע)</B> סטור. פורמולת הגנה מפורסמת. העדות המוקדמת ביותר לשימוש בה נמצאה בהריסות העיר הרומאית פומפיי (79 לספירה).
saturnian	<B>(ש"ת)</B> סטורני, בן תור הזהב.
saturnine	<B>(ש"ת)</B> נולד במזל שבתאי.
saxon|anglo saxon|anglo-saxon	<B>(ש"ת)</B> סקסוני. בן שבט טבטוני שכבש את אנגליה במאות החמישית והשישית.
sbylline	<B>(ש"ת)</B> של הסיבילות, נבואי.
scarab	<B>(ש"ע)</B> חרפושית, חיפושית-פרעה.
sceptre	<B>(ש"ע)</B> שרביט, שבט.
scourge	<B>(ש"ע)</B> שוט, פרגול, מגלב. אחד מכלי המכשפה הגרדנריאנית או האלכסנדרית. משמש לטיהור ובטקסי הכנסה בסוד.
scrying	נחש כדור בדולח, נחש צלול. (שיטת הגדת עתידות).<BR>
sea god	<B>(ש"ע)</B> אל הים.
sea goddess	<B>(ש"ע)</B> אלת הים.
seal	<B>(ש"ע)</B> חותם.
second degree initiation	<B>(ש"ע)</B> הכנסה בסוד לדרגה שנייה.
second sight	<B>(ש"ע)</B> ראיית נסתרות.
secret society	<B>(ש"ע)</B> אגודת סתר, אגודת סתרים.
sect	<B>(ש"ע)</B> כת, כיתה.
see visions	<B>(ש"ע)</B> לראות חזיונות.
seedtime	<B>(ש"ע)</B> עונת הזריעה, סוף חודש יוני.
seeker	<B>(ש"ע) </B>מבקש דרך, שוחר. אדם הנמצא בתהליכי חיפוש רוחני והמתנסה אצל מספר מסדרים מאגיים או קבוצות כישוף לפני שהוא מתחייב לדרך מסוימת.
selenite	<B>(ש"ע)</B> סלניט (סוג אבן טובה).
self dedication|self initiation	<B>(ש"ע)</B> הקדשת העצמי. טקס שבו מקדישה המכשפה המתחילה את עצמה לאומנות הכשפים ולשירות האלוהות.
sem|sem priest|sem-priest	(ש"ע) סם. הכהן הגדול במצרים העתיקה, מכונה גם "נביא האל הראשון". שימש יועץ לפרעה והיו לו תפקידים פוליטיים ודתיים כאחד.
sending	<B>(ש"ע)</B> שילוח. סוג כישוף.
seshaw	<B>(ש"ע)</B> סשאו. טקסים מאגיים או פעולות מאגיות במצרים העתיקה.
sex magic	<B>(ש"ע)</B> כשף מין.
shade	<B>(ש"ע)</B> שד צללים. במאגיה, רוח או ישות המסרבת לעזוב את העולם הפיזי.
shadow	<B>(ש"ע)</B> צל, שד, רוח, רפא.
shadow of death	<B>(ש"ע)</B> צלמוות.
shaman	(ש"ע) שמאן.
shamanism	<B>(ש"ע)</B> שמאניזם, שמאניות. "הדת הראשונה", שיטה דתית מאגית של העמים בצפון אסיה וצפון אירופה.
shape shifting|shape-shifting	<B>(ש"ע)</B> שינוי צורה, מטמורפוזה.
showstone	<B>(ש"ע)</B> אבן ראייה. קריסטל מלוטש בצורת כדור, המשמש להגדת עתידות ולראייה לתוך המישור האסטרלי.
shrine	<B>(ש"ע)</B> ארון קודש.
sia	<B>(ש"ע)</B> סיה. בדת המצרית העתיקה, עקרון הידיעה האלוהית.
sibyl	<B>(ש"ע)</B> סיבילה.
sickle	<B>(ש"ע)</B> חרמש, מגל.
sigil	<B>(ש"ע)</B> סיגיל, אות מסתורי, שם כוח, חותמת, חותם.
sign	<B>(ש"ע)</B> סימן.
sign of the Zodiac	<B>(ש"ע)</B> מזל (באסטרולוגיה).
signet ring	<B>(ש"ע)</B> טבעת חותם.
silver	<B>(ש"ע)</B> כסף. בפולקלור ובמאגיה, מתכת בעלת סגולת הגנה וגירוש. קשורה לירח ולאלוהוית הירח. במיתולוגיה הקלאסית קשורה במיוחד לאלה סלין. במיתולגיה הכנענית קשורה לבעל, כושר וחסיס ואשרה.
siren	<B>(ש"ע)</B> סירנה.
sistrum	<B>(ש"ע)</B> סיסטרום, רעשן קדוש במצרים העתיקה.
sisyphean	<B>(ש"ת)</B> סיזיפי.
skyclad	<B>(ש"ת)</B> עטוי גלימת שמים, עירום.
smokey quarz	<B>(ש"ע)</B> סמוקי קוורץ, קוורץ עשן (סוג אבן טובה).
smudging	<B>(ש"ע) </B>העשנה. בתרבות הילידית באמריקה, טקס טיהור באמצעות נפנוף צרור עשבים בוערים מסביב לאדם.
snail	<B>(ש"ע)</B> חלזון. רכיכה המשמשת להגדת עתידות אהבה בליל סמהין.
snakeroot	<B>(ש"ע)</B> שורש הנחש. שם עממי לצמח שעל פי הפולקלור ירפא עקיצות נחשים.<BR>
snakestone	<B>(ש"ע)</B> אבן הנחש (צדפה מאובנת). על פי האמונה העממית, תרפא נשיכות נחש.
snowflake obsidian	<B>(ש"ע)</B> סנופלייק אובסידיאן (סוג אבן טובה).
soapwort	<B>(ש"ע)</B> סבונית רפואית, בורית רפואית, אוצרות רוח. צמח המשמש במאגיה וברפואה העממית. אחד מתשעת צמחי המרפא הקסומים של המיתולוגיה האנגלו-סקסית. שמו הלטיני Saponaria officinalis.
socrceres' grease|sorcerers grease|sorrcerer's grease	<B>(ש"ע)</B> משחת קסמים.
sodalite	<B>(ש"ע)</B> סודליט (סוג אבן טובה).
solar	<B>(ש"ת)</B> שמשי, של השמש.
solar tide	<B>(ש"ע)</B> מועד שמשי.
solar year	<B>(ש"ע)</B> שנת חמה.
solarism	<B>(ש"ע)</B> חמנות. פולקלור השמש ופעולותיה.
solstice	<B>(ש"ע)</B> סולסטיציום, יום תקופה, היפוך.
son of Neptune	<B>(ש"ע)</B> מלח, ספן, יורד ים. נקרא כך מפני שנפטון אל הים הרומאי הוא פטרון יורדי הים.
soothsay	<B>(ש"ע)</B> נחש, הגדת עתידות.
soothsayer	<B>(ש"ע)</B> מנחש, מגיד עתידות.
sorcerer	<B>(ש"ע)</B> קוסם.
sorceress	<B>(ש"ע)</B> קוסמת.
sorcery	<B>(ש"ע)</B> קסם, קסמים, קוסמות.
sorel|sorrel	<B>(ש"ע)</B> חומעה. צמח בר ממשפחת הרב ברכיים.
sortilege	<B>(ש"ע)</B> הפלת גורלות.
soul	<B>(ש"ע)</B> נשמה. החלק הרוחני והנצחי באדם.
sow thistle|thistle	<B>(ש"ע)</B> קיצנית מצויה.<BR>צמח המקודש לאל הגרמאני תונור. שמו הלטיני Carlina vulgaris.
spell	<B>(ש"ע)</B> כישוף.
spell book	<B>(ש"ע)</B> ספר כישופים.
spellbind	<B>(פ')</B> לרתק בחבלי קסם, לקשור בחבלי קסם.
spellbound	<B>(ש"ת)</B> אחוז חבלי קסם.
spellcrafting	<B>(ש"ע)</B> כתיבת כישופים. במאגיה, כתיבה ויצירה של כישופים חדשים.
sphinx	<B>(ש"ע)</B> ספינקס.
spider	<B>(ש"ע)</B> עכביש.
spiral	<B>(ש"ע)</B> לוליני, ספירלי, סלילי, פתלתול.
spirit	<B>(ש"ע)</B> רוח.
spiritual	<B>(ש"ת)</B> רוחני.
spiritual leader	<B>(ש"ע)</B> מנהיג רוחני, רועה רוחני.
spiritualism	<B>(ש"ע)</B> ספיריטואליות. האמונה שניתן להתקשר עם רוחות בעזרת מדיום.
spittle	<B>(ש"ע)</B> רוק.
spring equinox|vernal equinox	<B>(ש"ע)</B> השתוות אביבית, שוויון אביבי. אחד משמונת חגי השמש בגלגל השנה הפגני. נחגג בתאריך 21 למרץ.
springtide	<B>(ש"ע)</B> שיא הגאות, בראש חודש ובאמצע החודש בהשפעת השמש והירח.
sprite	<B>(ש"ע)</B> ספרייט.
staff	<B>(ש"ע)</B> מטה.
stag	<B>(ש"ע)</B> צבי.
stake	<B>(ש"ע)</B> עמוד התלייה, עמוד השריפה. בימי הביניים: גורלן של מכשפות רבות.
star	<B>(ש"ע)</B> כוכב, מזל, גורל.
stime	<B>(ש"ע)</B> קחון אצילי. אחד מתשעת הצמחים המרפאים של המיתולוגיה האנגלו סקסית. שמו הלטיני Anthemis nobilis
stolist	<B>(ש"ע)</B> סטוליסט. כהן-אורקל במצרים העתיקה, שבין השאר היה עליו להאכיל ולהלביש את פסלי האלים ולנעול את דלתות המקדש בלילות.
stone	<B>(ש"ע)</B> אבן. סמל לכל טוב האדמה וסמל של יסוד הארץ. במאגיה, בפולקלור ובריפוי עממי משתמשים באבנים למטרות שונות ומגוונות.
storm raising	<B>(ש"ע)</B> גרימת סופה. במאגיה: סוג של מלפיקיה.
strawberry	<B>(ש"ע)</B> תות שדה. בפולקלור ובמאגיה, סמל אהבה ותשוקה. מקודש לאלת הפריון הנורדית פריג ולאלה הגרמאנית הולה או פראו הולה. על פי האמונה העממית בצפון אירופה, האלבנקינד, ילדי העלפים, חובבים תותי שדה ולכן ניתן לשחד אותם בפרי.
strawberry quarz	<B>(ש"ע)</B> קוורץ תות (סוג אבן טובה).
stygian	<B>(ש"ע)</B> סטיקסי, של נהר הסטיקס.
succuba	<B>(ש"ע)</B> סוקובה.
succubus	<B>(ש"ע)</B> סוקובוס. צורת רבים של סוקובה.
sugilite	<B>(ש"ע)</B> סוג'ילית (סוג אבן טובה).
summer solstice	<B>(ש"ע)</B> היפוך הקיץ, אחד בתקופת תמוז, יום תקופת תמוז, סולסטיציום קיץ. היום הארוך בשנה ואחד משמונת החגים בגלגל השנה הפגני. נחגג בתאריך 21 יוני.
summerland	<B>(ש"ע)</B> ארץ הקיץ. במיתולוגיה הקלטית, העולם הבא, שבו נחה ומתחדשת רוח האדם לפני שהיא שבה לארץ בגלגולה הבא.
summoner|fetch	<B>(ש"ע)</B> מזמן. מכשף העוסק בזימון שדים, רוחות וישויות אחרות מן המישור האסטרלי.<HR><B>(ש"ע) </B>מזמנת. מכשפה שתפקידה להודיע לחברי האסיפה מתי והיכן מתקיימים הכינוסים, המועדים והחגיגות.
summoning	<B>(ש"ע)</B> זימון. שיטה מאגית של קריאה לרוחות, לשדים ולשאר ישויות מן המישור האסטרלי.
sun	<B>(ש"ע)</B> שמש, חמה. בפולקלור ובדתות פגניות חדשות: סמל אלוהות הגברית, אור, השכלה, בינה, יצירתיות וקידמה.<HR><B>(ש"ע) </B>כינוי לאל השמש, כינוי לאלוהים, אפולו.<BR>
sun dance	<B>(ש"ע)</B> מחול השמש. ריקוד אינדיאני להיפוך הקיץ.
sun disk	<B>(ש"ע)</B> גלגל השמש, דיסקת השמש. סמל אל השמש במזרח התיכון הקדום.
sun god	<B>(ש"ע)</B> אל השמש.
sun worship	<B>(ש"ע)</B> פולחן השמש.
sunstone	<B>(ש"ע) </B>סנסטון אבן השמש (סוג אבן טובה).
sunwise	<B>(תה"פ)</B> בכיוון השמש, בכיוון השעון, ימינה.
swan maiden	<B>(ש"ע)</B> עלמה ברבור. בפולקלור, נערה המסוגלת להפוך עצמה לברבור.
swastika	<B>(ש"ע)</B> סווסטיקה, צלב הקרס. במקור, סמל לשמש במעגלה היומי וקמע מזל. הנאצים אימצו אותה כסמלם.
swear an oath	<B>(פ')</B> להישבע.
sweet oil	<B>(ש"ע)</B> שמן זית.
swimming	<B>(ש"ע)</B> הטבעה. טכניקת עינוי מכשפות שהיתה נפוצה בימי הביניים.
sword	<B>(ש"ע)</B> חרב. אחד מכלי המכשפה. מסמלת גבריות ואת יסוד האש. משמשת להטלת מעגל ולזימון רוחות מסוימות.
sword of Damocles	<B>(ש"ע)</B> חרב דמוקלס.
sycamore	<B>(ש"ע)</B> שקמה.
sylph	sbylline סילף, אוורירית. רוח מכונפת שוכנת אויר, המסמלת את רוח יסוד האויר.
sylvan	<B>(ש"ע)</B> סילבן, שד יערות, שעיר.
symbol	<B>(ש"ע)</B> סמל.
symbolatry	<B>(ש"ע)</B> פולחן סמלים.
symbolic	<B>(ש"ת)</B> סמלי.
symbolics	<B>(ש"ע)</B> תורת הסמלים, חקר טקסים סמליים.
symbolize	<B>(פ')</B> לסמל.
sympathetic magic	<B>(ש"ע)</B> כשף זיקה.
syrup	<B>(ש"ע)</B> סירופ. בפולקלור ובמאגיה, סוג של שיקוי צמחי ממותק בדבש.
tactite	<B>(ש"ע)</B> טקטיט (סוג אבן טובה).
take a vow|take an oath	<B>(ש"ע)</B> להישבע, להתחייב בשבועה.
talisman	<B>(ש"ע)</B> טליסמא, סגולה. במאגיה: חפץ בעל תכונות פנימיות מעבר לחיצוניותו. למשל, לשום יש סגולה לגרש רוחות רעות.
talismanic	<B>(ש"ת)</B> טליסמאי, בעל סגולה.
tamarix	<B>(ש"ע)</B> אשל. עץ המקודש לאל הכנעני חורון.
tanist	<B>(ש"ע)</B> יורש ראש השבט הקלטי.
tanistry	<B>(ש"ע) </B>בתרבות הקלטית, בחירת יורש לראש השבט. שיטה אירית לקביעת ראש השבט מבין טוביו, כיוון שראשות השבט אינה עוברת בירושה.
tansy	(ש"ע) בן חרצית מצוי. בפולקלור הגרמאני, אחד הצמחים המסורתיים של חג אוסטרה (השוויון האביבי) ומקודש לאלה אוסטרה. שמו הלטיני: Tanacetum vulgare.
tarot	<B>(ש"ע)</B> טארוט, קלפי טארוט.
tasseomancy|tasseography	<B>(ש"ע)</B> קריאה בעלי תה (שיטת הגדת עתידות).
tea leaves	<B>(ש"ע)</B> עלי תה. בפולקלור ובמאגיה, משמשים להגדת עתידות.
tears	<B>(ש"ע)</B> דמעות.
teasel	<B>(ש"ע)</B> קרד. <BR>צמח שאת זרעיו נהגו לתלות על פלך הטוויה. מקודש לאלות הטוויה הולה ופריג. אחד מן הצמחים המסורתיים של השוויון האביבי ומקודש לאלת האביב הגרמאנית אוסטרה. שמו הלטיני: Dipsacus sylvestris.
telekinesis	<B>(ש"ע)</B> טלקינזיס, הנעה מרחוק. שיטה פסיכוקינטית של הזזת חפצים בעזרת כוח המחשבה.
telepathy	<B>(ש"ע)</B> טלפתיה. תקשורת מוחית או רוחנית לא פיזית בין אנשים.
teleportation	<B>(ש"ע)</B> טלפורט, שיגור עצמים.
tell fortune	<B>(פ')</B> לנבא את העתיד, לגלות עתיד.
temple	<B>(ש"ע)</B> מקדש.
teuton	<B>(ש"ע)</B> טבטוני, גרמאני.
teutonic	<B>(ש"ת)</B> טבטוני, גרמאני.
teutonism	<B>(ש"ע)</B> טבטוניות, גרמאניות.
thaumaturge	<B>(ש"ע)</B> עושה מופתים.
thaumaturgy	<B>(ש"ע)</B> עשיית מופתים.
the Scales	<B>(ש"ע)</B> מזל מאזניים.
the Sight	<B>(ש"ע)</B> ראיית נסתרות.
the four elements|elements|the elements	<B>(ש"ע)</B> ארבעת היסודות.
the magical voice|magical voice|magickal voice|the magickal voice	<B>(ש"ע)</B> הקול המאגי. במאגיה, טון מצווה ותקיף שבו מדקלמים לחשים ומילות קסם.
the other world	<B>(ש"ע)</B> העולם הבא.
the seven sages	<B>(ש"ע)</B> שבעת חכמי יוון.
the shades	<B>(ש"ע)</B> עולם הרפאים, שאול.
the stake	<B>(ש"ע)</B> מוות בשריפה. בימי הביניים, גורלן של מכשפות רבות.
the world beyond	<B>(ש"ע)</B> העולם הבא.
thegn	<B>(ש"ע)</B> תין. כינוי כבוד ותואר אצילות קלטי ואסטרוארי.
theogonic	<B>(ש"ת)</B> תאוגוני.
theogony	<B>(ש"ע)</B> תאוגוניה. תורת בריאת האלים.
theological	<B>(ש"ת)</B> תאולוגי.
theology	<B>(ש"ע)</B> תאולוגיה. תורת האלוהות.
theomachy	<B>(ש"ע)</B> מלחמת האלים, מריבת האלים.
theomorphic	<B>(ש"ת)</B> תאומורפי, בצלם אלוהים.
theopathy	<B>(ש"ע)</B> תחושת התעלות דתית.
theophany	<B>(ש"ע)</B> התגלות האלוהים לאדם.
theorphany	התגלות.
therianmorphic	<B>(ש"ע)</B> יצור פלאי או אל בדמות אדם או חיה.
theriomorphic	<B>(ש"ת)</B> של אל בדמות בעל חיים.
theurg	<B>(ש"ע)</B> תאורג.
theurgic	<B>(ש"ת)</B> תאורגי.
theurgy	<B>(ש"ע)</B> תאורגיה. שיטה מאגית העוסקת בקרבה לאלוהות ולישויות אלוהיות.
third degree initiation	<B>(ש"ע)</B> הכנסה בסוד לדרגה שלישית.
third eye	<B>(ש"ע)</B> העין השלישית. על פי האמונה המצרית, איבר ראייה רוחני, הממוקם באמצע המצח.
thistle	<B>(ש"ע)</B> קרצף מבורך.<BR>קוץ המקודש לאל הרעם הגרמאני תונור. <BR><BR><BR><BR><BR><BR><BR><BR><BR><BR><HR><B>(ש"ע)</B> קוצן פשוט.<BR>קוץ המקודש לאל הרעם הגרמאני תונור. שמו הלטיני: cirsium vulgare.<BR>
thorn apple	<B>(ש"ע)</B> דטורה.
thorn letter	<B>(ש"ע)</B> האות האנגלו סקסית p המבוטאת th.
thoth	<B>(ש"ע)</B> תחות.
thought form	<B>(ש"ע)</B> צורת מחשבה.
thought transference	<B>(ש"ע)</B> העברת מחשבות, טלפתיה.
thought wave	<B>(ש"ע)</B> גל טלפתי.
thoughtreader	<B>(ש"ע)</B> קורא מחשבות.
thoughtreading	<B>(ש"ע)</B> קריאת מחשבות.
threefold law of return|boomerang effect|karma law|law of karma|law of return|law of three|the boomerang effect|the karam law|the law of karma|the law of return|the law of three|the threefold law	<B>(ש"ע)</B> חוק השילוש, חוק הקרמה, חוק החזרה פי שלוש, החוק המשולש. בדתות פגניות חדשות, כלל מוסרי לפיו כל מעשה מאגי יחזור לעושהו בעוצמה חזקה פי שלוש.
thyme	<B>(ש"ע)</B> בת קורנית מצויה<BR>נקרא גם בלשון הדיבור: טימין, קורנית. צמח בר ממשפחת השפתניים, המשמש במאגיה וברפואה העממית. בפולקלור של צפון אירופה נחשב צמח עלפים. שמו הלטיני Thymus vulgaris.
tide	<B>(ש"ע)</B> מועדי ים, גאות ושפל, שטפון.
tiger eye|tiger's eye	<B>(ש"ע)</B> עין הנמר (סוג אבן טובה).
tincture	<B>(ש"ע)</B> תמצית. בפולקלור ובמאגיה, סוג של שיקוי, הנוצר על ידי יציקת אלכוהול (בדרך כלל יין) על חלקי צמחים.
titan	<B>(ש"ע)</B> טיטן.
toad	<B>(ש"ע)</B> קרפדה.
toad stone	<B>(ש"ע)</B> אבן קרפדה. סוג אבן קמע.
topaz	<B>(ש"ע)</B> טופז, פטדה (סוג אבן טובה).
totem|totem animal	<B>(ש"ע)</B> טוטם.
totem pole	<B>(ש"ע)</B> עמוד טוטם.
totemic	<B>(ש"ת)</B> טוטמי.
totemism	<B>(ש"ע)</B> טוטמיזם.
totemist	<B>(ש"ע)</B> בעל טוטם.
totemistic	<B>(ש"ת)</B> טוטמי.
touch wood	הקש בעץ, בלי עין הרע.
tourmaline	טורמלין (סוג אבן טובה בצבעים שונים).
tourmaline quarz	<B>(ש"ע)</B> טורמלין קוורץ (סוג אבן טובה).
tradition	<B>(ש"ע)</B> מסורת, מסורה.
traditionist|traditional|traditionalist	<B>(ש"ע)</B> מסורתי, שומר מסורת. בויקה, מאמין ששם יותר דגש על מסורות מימי עברו וכתבי המלומדים ופחות על השראה דתית אישית.
trance	<B>(ש"ע)</B> טראנס.
transmutation	<B>(ש"ע) </B>התמרה. באלכימיה, הטכניקה של הפיכת מתכות בסיסיות לכסף ולזהב.
trefoil	<B>(ש"ע)</B> תלתן. סוג צמחים בעלי עלים משולשים ממשפחת הקטניות.
triad	<B>(ש"ע)</B> שלישייה, שילוש, שילוש קדוש. בדתות פגניות, שלישיית אלים שפולחנם נעשה בצוותא.
tripple goddess	<B>(ש"ע)</B> האלה המשולשת.
troll	<B>(ש"ע) </B>יצור דמוי אדם מכוער ומרושע במיתולוגיה הסקנדינבית.
truffle	<B>(ש"ע)</B> כמהה, כמהין. פטריות נדירות ויקרות, המשמשות כמרכיב מעורר תשוקה בשיקויי אהבה ובמאכלי אהבה רבים (אפרודיזיאק).
turquoise	<B>(ש"ע)</B> טורקיז (סוג אבן טובה). אחת משלושת האבנים המקודשות במצרים העתיקה.
turquonite	טורקוניט (סוג אבן טובה). אבן מגנזניט צבועה טורקיז.
twlefth night|twelfth-night	<B>(ש"ע)</B> בדת הגרמאנית, היום השנים עשר לחגיגת יול וערב השנה החדשה.
ugrian|ugric	<B>(ש"ת)</B> אוגרי<BR><B>(ש"ע) </B>הלשון האוגרית.
ululation	<B>(ש"ע)</B> שוועה. אמירת לחש קסם בטון סמכותי.
unacite	<B>(ש"ע)</B> אונקיט, יונקיט (סוג אבן טובה).
uncasting	<B>(ש"ע)</B> פיזור. במאגיה ובדתות פגניות, גירוש המעגל בתום הטקס.
underworld	<B>(ש"ע)</B> העולם התחתון, שאול, שאול תחתיות.
undine	<B>(ש"ע)</B> אונדינה, בת גלים. רוח שוכנת מים המייצגת את רוח יסוד המים.
unicorn	<B>(ש"ע)</B> חד קרן.
unmanifest	<B>(ש"ע)</B> הלא גלוי. במאגיה, מקור הקיום הבלתי ידוע, שממנו ניתן לשאוב כוח פסיכי.
uraerus	<B>(ש"ע)</B> יוראוס. צפע השלטון, המסמל מלכות ושלטון בדת המצרית.
urine	<B>(ש"ע)</B> שתן.
ushabti	<B>(ש"ע)</B> אושבטי. סוג פסלון מצרי.
valerian|Wayland's Wort	<B>(ש"ע)</B> ולריאן, ולרינה. בתרבות הגרמאנית, צמח המקודש לאל הנפחים האנגלו סקסי, ווילנד. בפולקלור צמח המשמש להתקשרות עם המתים ולכשפי אהבה. שם לטיני: Valeriana.
valkyrie|waelcyrge	<B>(ש"ע)</B> ולקירית, ולקיריה. "בוחרת הרוגים". במיתולוגיה הנורדית, אחת מקבוצה של רוחות נערות המשרתות את אודין. הן מלוות אותו לשדה הקרב הן מסייעות לו לבחור את נשמותיהם של הטובים והאמיצים ביותר שנפלו במלחמה. יחדיו הם מובילים את הנשמות להיכלו של אודין, וולהאלה, בתהלוכה רבת רושם, הנקראת המצוד הפראי.
vampire	<B>(ש"ע)</B> ערפד.
vampiric	<B>(ש"ת)</B> ערפדי.
vampirism	<B>(ש"ע)</B> ערפדיות, אמונה בערפדים.
vanilla	<B>(ש"ע)</B> וניל, שנף. צמח ממשפחת ממשפחת הסחלביים, המשמש להפקת תבלין, קטורת ושמנים מאגיים. בפולקלור ובמאגיה מסמל אהבה. אפרודיזיאק ידוע. שמו הלטיני של הצמח: vanilla planifolia.
veil of unknowing	<B>(ש"ע)</B> רעלת הבלתי ידוע. כינוי לגבול בין העולם הארצי לבין העולם הרוחני.
vervain	<B>(ש"ע)</B> ורבנה רפואית. <BR>צמח המשמש במאגיה וברפואה העממית. נחשב צמח אהבה וכלולות. הדרואידים נהגו לקצור אותו בכלי ברזל בעת זריחת כוכב סיריוס, כשלא השמש ולא הירח נראים בשמים. הם נהגו למזוג דבש על האדמה כדי לפצות אותה על הצמח שקטפו. על פי האמונה העממית, מי שישתה שיקוי של הצמח, יצליח לראות את חוטי ווירד, אלות הגורל. שמו הלטיני Verbena officinalis.
vestal	<B>(ש"ת)</B> וסטלי, של וסטה.
vestal virgin	<B>(ש"ע)</B> בתולה וסטלית, וסטלה.
vine|vine grape	<B>(ש"ע)</B> גפן. <BR>צמח המסמל את הגבול בין העולם הזה לעולם הבא (מפני שפירותיו משמשים להפקת יין משכר, שפותח את השער לעולם האחר). מקודש לאל הגפנים הכנעני גפן. עץ החודש העשירי בלוח העצים הקלטי: 2 ספטמבר - 29 ספטמבר.
violet	<B>(ש"ע)</B> סיגלית, סיגל. פרחים בעלי עלי כותרת ורודים וסגולים, המשמשים בשיקויי אהבה. שם לטיני: Viola.
virtues	<B>(ש"ע)</B> סגולות. במאגיה ובפולקלור, מאפיינים מאגיים הטבועים בכל חפץ שהוא, במיוחד בעשבים, באבנים ובבעלי חיים.
visigothic	<B>(ש"ת)</B> ויזיגותי, גותי מערבי.
vision	<B>(ש"ע)</B> חזיון.
vision questing	<B>(ש"ע)</B> מסע אל החזון. טכניקה מאגית של חיפוש מטרה ותכלית באמצעות מסע אסטרלי.
visualization	<B>(ש"ע)</B> הדמייה, העלאה בדמיון. טכניקה מאגית של השפעה על חפצים ומצבים באמצעות יצירתם בדמיון.
voodoo	<B>(ש"ע)</B> וודו.
voodooism	<B>(ש"ע)</B> אמונה בוודו, תורת הוודו.
voodooist	<B>(ש"ע)</B> מאמין בוודו.
voodooistic	<B>(ש"ת)</B> של וודו.
vouch	<B>(ש"ע) </B>גושפנקא. אישור בכתב או בעל פה מזקני עדה או קהילית כישוף כי אדם מסוים התחנך אצלם, ועבר חניכה לאחת הדרגות.
walnut	<B>(ש"ע)</B> אגוז, אגוז מלך. <BR>על פי האמונה העממית, מכשפות, עלפים ודוורפים מתכנסים תחת ענפי עץ האגוז. בעבר נהגו לחרוך ענף אגוז במדורה המסורתית של חג אוסטרה ולהשתמש בו כסגולה להגנה מפני מכות ברקים.<BR>
wand	<B>(ש"ע)</B> מטה, מטה קסמים, מטה קוסמים. אחד מכלי המכשפה. משמש לזימון רוחות מסוימות ולעיגול מעגלים.
wane	<B>(ש"ע)</B> התמעטות הלבנה.
waning moon	<B>(ש"ע)</B> ירח מתמעט, הלבנה בהתמעטותה.
war god	<B>(ש"ע)</B> אל המלחמה.
ward	<B>(ש"ע)</B> סיכול. במאגיה, כישוף הגנה.
warlock	<B>(ש"ע)</B> וורלוק, כשפן, מפר שבועות. כינוי גנאי למכשף. כינוי של לא מאמינים בויקה למכשף.<BR><HR><B>(ש"ע)</B> וורלוק. בוגד בשבועת האמונים הסודית לויקה המסורתית.
watcher	<B>(ש"ע)</B> צופה. סוג של צורת מחשבה אליה מעביר המכשף חלקים מכוחו ומחבר אותה בקישור אסטרלי לאדם אחר.
watchtowers	<B>(ש"ע)</B> מגדלי השמירה.
water	<B>(ש"ע)</B> מים. אחד מארבעת היסודות המאגיים בטבע.<BR>
water nymph	<B>(ש"ע)</B> נימפת מים.
water sprite	<B>(ש"ע)</B> ספרייט מים, רוח שוכנת מים.
wax image	<B>(ש"ע)</B> דמות שעווה.
waxing moon	<B>(ש"ע)</B> ירח מתמלא.
weather magic	<B>(ש"ע)</B> כשף מזג אויר.
webweaving	<B>(ש"ע)</B> טווית קורים. בדתות פגניות חדשות, מונח המתאר יצירת קשרים עם פגנים אחרים כדי ליצור מסדר, מעגל, אסיפה או קבוצת לימוד.
well	<B>(ש"ע)</B> באר. מקום קדוש בדת הקלטית.
werewolf|wrwulf	<B>(ש"ע)</B> אדם זאב, מזדאב.
wheat	<B>(ש"ע)</B> חיטה. סוג תבואה המקודש לאלות הצמיחה והאדמה ומסמל פריון.
wheel	<B>(ש"ע)</B> גלגל.
wheel of the year	<B>(ש"ע)</B> גלגל השנה. מונח המתאר את שמונת חגי השמש הפגניים: סו-ווין, יול, אימבולג, אוסטרה, בלתיין, מידסאמר, לונאסה, מבון.
white magic	<B>(ש"ע)</B> מאגיה לבנה, כשף לבן, כשפים לבנים.
wicca	ויקה.<BR>דת חידוש פגנית שנוסדה באמצע המאה העשרים על ידי המכשף ג'ראלד גרדנר.
wiccan	<B>(ש"ע)</B> ויקני, מאמין בויקה.
wiccanning	<B>(ש"ע)</B> הקדש ויקני. טקס הקדשת הרך הילוד לויקה.
wicce	<B>(ש"ע)</B> וויצ'ה.
widdershins|withershins	<B>(תה"פ)</B> איפכא. להיפך. נגד כיוון השמש, נגד כיוון השעון, שמאלה. המונח מתאר תנועה נגד הכיוון המקובל בתוך המעגל המאגי הקדוש. במסורות כישוף מסוימות, נחשבת תנועה בכיוון ההפוך לטאבו דתי. במסורות אחרות היא משמשת לשם הטלת קללות, כישופי כפיתה וכישופי גירוש.
will-o'-the-wisp|will o the wisp|will o' the wisp|will-o-the-wisp	<B>(ש"ע)</B> זהר רפאים.
willow	<B>(ש"ע)</B> ערבה לבנה. <BR>עץ החודש החמישי בלוח העצים הקלטי: 15 אפריל - 12 מאי. מקודש לאל הגרמאני וודן ולולקיריות. עץ מרפא המשמש לטיהור ברפואה העממית. נחשב עץ החיים וסמל למים חיים, אך גם סמל של לוווית, עצב ושברונות לב. ענפי העץ משמשים בקללות קשירה. בארצות הסלביות נהגו להכין מן העץ לפידים לחגיגות היפוך הקיץ. שמו הלטיני Salix alba.
wine	<B>(ש"ע)</B> יין. <BR>נחשב למשקה אלוהי, בגלל יכולתו לשנות את מצב המודעות של האדם. מרכיב חשוב בטקסים דתיים ומאגיים רבים. מקודש לאלי היין והגפן כגון: דיוניסוס, בכחוס, גפן. נחשב אפרודיזיאק חזק מאוד ולכן מרכיב חשוב בשיקויי אהבה רבים.
winter solstice	<B>(ש"ע)</B> היפוך החורף, אחד בתקופת טבת, סולסטיציום חורף. היום הארוך בשנה ואחד משמונת חגי השמש בגלגל השנה הפגני. נחגג בתאריך 21 לדצמבר.
wise	<B>(ש"ת)</B> בקי בחכמת הכישוף.
wise woman	<B>(ש"ע)</B> אשה חכמה. <BR>כינוי למכשפה עממית באנגליה, במיוחד החל מתקופת בית טיודור ואילך. בדרך כלל בקיאה בעשבונאות, מיילדת ובעלת קורפוס של פורמולות כישוף פשוטות.
wish bone	<B>(ש"ע)</B> עצם המשאלות. עצם משולשת בחזה העוף המשמשת להגדת עתידות.
wish ring	<B>(ש"ע)</B> טבעת משאלות.
witch	<B>(ש"ע)</B> מכשפה.
witch ball	<B>(ש"ע)</B> כדור מכשפות. כדור זכוכית המשמש להגנה.
witch bottle	<B>(ש"ע)</B> בקבוק מכשפות. סוג כישוף.
witch hunt	<B>(ש"ע)</B> ציד המכשפות, ציד מכשפות.
witch ladder	<B>(ש"ע)</B> סולם מכשפות. סוג כישוף.
witch prayer	<B>(ש"ע)</B> תפילת מכשפות. שם נפוץ לתפילות לאלים ולאלות בויקה.
witch queen	<B>(ש"ע)</B> מלכת מכשפות. כוהנת גדולה שמן האסיפה שלה נפרדו בצוותא לפחות שלוש אסיפות בנות.
witchcraft	<B>(ש"ע)</B> אומנות הכשפים.
witchery	<B>(ש"ע)</B> מכשפוּת.
witches' sabbat|witches sabbat	<B>(ש"ע)</B> שבת המכשפות, כנס מכשפות.
witching	<B>(ש"ע)</B> כישוף, הכשפה.
witching hour	<B>(ש"ע)</B> שעת המכשפות. כינוי לשעת חצות, מפני שעל פי האמונה המאגית, זהו הזמן הטוב ביותר לכשפים.
wizard	<B>(ש"ע)</B> אשף.
wizardry	<B>(ש"ע)</B> אשפות.
wonder	<B>(ש"ע)</B> פלא.
wonder-worker|wonder worker	<B>(ש"ע)</B> מחולל נפלאות.
wonderwork	<B>(ש"ע)</B> מעשה פלא.
wood nymph	<B>(ש"ע)</B> נימפת יערות.
wood sorrel	<B>(ש"ע)</B> חמציץ.
woodruff	<B>(ש"ע)</B> חספסנית ריחנית.
work magic	<B>(פ')</B> להטיל כשפים.
working magic	<B>(ש"ע)</B> כשף מעשי.
working partner	<B>(ש"ע)</B> בן זוג לעבודת הכשפים.
wormwood|common wormwood	<B>(ש"ע)</B> לענה מדברית.<BR>נקרא גם שיבא. צמח המשמש במאגיה וברפואה העממית. שמו הלטיני Artemisia absinthium.
worship	<B>(ש"ע)</B> פולחן, עבודת אלוהים.
worshipper	<B>(ש"ע)</B> מאמין, סוגד, עובד האלוהים.
wort	<B>(ש"ע)</B> עשב.
wyvern coven|dragon coven	<B>(ש"ע)</B> אסיפת וויברן. <BR>כינוי לאספת מכשפות המורכבת מנערים ונערות צעירים, בדרך כלל בגילאי שתים עשרה עד עשרים. מסורות ויקה מסוימות גורסות כי בגילאים אלו לאדם יש את הכוח המאגי הרב ביותר וכי בגיל מתקדם יותר על האדם להתאמן רבות כדי לחזור לשלב הכוח המאגי הראשוני שהיה לו בצעירותו. וויברן הוא יצור מיתולוגי יורק אש דמוי לטאה מכונפת בעלת שתי גפיים. לעיתים מכונות אסיפת וויברן גם בשם אסיפת דרקון.
yarrow|milifoil	<B>(ש"ע)</B> אכיליאה אלף העלה. <BR>צמח המשמש במאגיה וברפואה העממית. אחד מן הצמחים המסורתיים של חג היפוך הקיץ. שמו הלטיני Achillea Millefolium.
yew	<B>(ש"ע)</B> טקסוס. <BR>עץ ממשפחת הטקסיים, מקודש בדת הקלטית. על פי אחת המסורות, עץ העולם במיתולוגיה הנורדית (גירסאות אחרות גורסות שעץ העולם הוא עץ מילה). קשור למוות, חיים ולוויות. מקודש לאל וודן. עץ מסורתית להכנת קשתות ומטות. שמו הלטיני Taxus baccata.
yuletide	<B>(ש"ע)</B> תקופת יול.
zodiac	<B>(ש"ע)</B> גלגל המזלות.
zodiacal	<B>(ש"ת)</B> של גלגל המזלות.
zombie	<B>(ש"ע)</B> זומבי, מת חי.<HR><B>(ש"ע) </B>פולחן הפיתון.
zoomancy	<B>(ש"ע)</B> נחש החי (שיטת הגדת עתידות בעזרת בעלי חיים).
zoomorphy	<B>(ש"ע)</B> זואומורפיה. יחוס תכונות בעלי חיים לאלים ולבני אדם.
zootheism	<B>(ש"ע)</B> זואותיאיזם. האלהת בעלי חיים.
