##name	��������� ����
##sourceLang	Hebrew
##targetLang	Hebrew
##bgl_defaultCharset	cp1255
##bgl_sourceCharset	cp1255
##bgl_targetCharset	cp1255
##bgl_defaultEncoding	cp1255
##bgl_sourceEncoding	cp1255
##bgl_targetEncoding	cp1255
##sourceCharset	UTF-8
##targetCharset	UTF-8
##author	Offir Lev-Ari
##email	offir.la@gmail.com
##copyright	������ �����; ����� 2008
##description	����� �������� ����� ������� ������ ���������� �����
##browsingEnabled	
##utf8Encoding	
##spellingAlternatives	
##caseSensitive	
##bgl_creationTime	2008/12/11, 11:24
##bgl_middleUpdated	2008/12/11, 21:25
##bgl_lastUpdated	2008/12/11, 21:25
אבד עליו הכלח	B: התיישן, עבר זמנו <br>
אבדון	B: חורבן, כליה <br>
אבה	B: רצה, חפץ <br>
אבולוציה	B: התפתחות איטית ומדורגת <br>
אבוס	B: כלי בו ניתן אוכל לבהמות; מפוטם <br>
אבוקה	B: לפיד, משואה <br>
אבות אכלו בושר ושיני בנים תקהינה	B: בנים נענשים וסובלים בגלל חטאי הוריהם <br>
אבות המזון	B: חומרי היסוד שמהם מורכב המזון <br>
אבחה	B: הנפה מהירה; טבח <br>
אבטיפוס	B: דוגמה ראשונה <br>
אבי אבות הטומאה	B: כינוי לגרוע שבגרועים <br>
אביון	B: עני, דל <br>
אביך	B: לא צלול, מלא אבק <br>
אבן בוחן	B: אמת מידה, קריטריון <br>
אבן הראשה	B: האבן המונחת במרכז קשת הבניין <br>
אבן יסוד	B: מרכיב חיוני, עליו מבוסס דבר מה שבלעדיו אין לו קיום <br>
אבן נגף	B: מכשול, תקלה <br>
אבן פינה	B: האבן הראשונה בבניין; יסוד ועיקר <br>
אבן ריחיים	B: עול כבד <br>
אבן שאין לה הופכין	B: כינוי למשהו שלאיש אין עניין בו <br>
אבן שואבת	B: כינוי לדבר שהוא מוקד התעניינות; מגנט <br>
אבן שפה	B: תחילת המדרכה, האבנים שבשולי הכביש <br>
אבנט	B: חגורה רחבה, אזור <br>
אבניים	B: גלגל האבן המסתובב באמצעותו יוצר הקדר כלי חרס <br>
אבנים שחקו מים	B: ההתמדה משתלמת <br>
אבסולוטי	B: מוחלט <br>
אבסורדי	B: אינו מתקבל על הדעת, נוגד את ההיגיון והשכל הישר <br>
אבסטרקטי	B: מופשט, לא מוחשי <br>
אברה	B: כנף של עוף <br>
אברך	B: איש צעיר; נשוי בשנותיו הראשונות <br>
אגב	B: בהזדמנות זו, תוך כדי כך <br>
אגב אורחא	B: בדרך אגב <br>
אגד	B: צרור; פלסטר <br>
אגוז קשה	B: כינוי לאדם עקשן; בעיה שקשה לפתור <br>
אגוצנטרי	B: מרוכז בעצמו <br>
אגל	B: רסיס, טיפה <br>
אגן	B: ספל, קערה <br>
אגרונום	B: מומחה בתחום החקלאות <br>
אגרסיבי	B: תוקפני <br>
אד הוק	B: לשם כך, לצורך עניין מסוים ומוגדר <br>
אדווה	B: גלים קטנים <br>
אדמת טרשים	B: אדמה סלעית שאינה ניתנת לעיבוד <br>
אדן	B: בסיס, יסוד <br>
אדר	B: פוחלץ <br>
אדרבה ואדרבה	B: נהפוך הוא, ההפך הוא הנכון <br>
אדרת	B: מעיל עליון רחב; תפארת <br>
אהבה אפלטונית	B: אהבה רוחנית ללא צד פיזי<br>
אהבה אפלטונית	B: אהבה רוחנית ללא צד פיזי <br>
אהבה התלויה בדבר	B: אהבה מתוך מניע <br>
אוב	B: כלי עור לנוזלים; כישוף <br>
אובד עצות	B: נבוך ומבולבל, שאינו יודע כיצד לנהוג <br>
אובייקטיבי	B: ענייני, חסר העדפה אישית <br>
אוד	B: גזיר עץ שאחזה בו אש אך לא נשרף כולו <br>
אוד מוצל מאש	B: כינוי לניצול, פליט <br>
אווילי	B: טיפשי, שטותי <br>
אוזלת יד	B: חוסר יכולת, אין אונים <br>
אוזניים לכותל	B: מצב שקשה לשמור בו סוד <br>
אוטודידקט	B: לומד בכוחות עצמו, אדם שרכש השכלה בכוחות עצמו <br>
אוטונומיה	B: עצמאות, שלטון עצמי <br>
אוטופיה	B: רעיון דמיוני שלא ניתן להגשימו במציאות <br>
אוטוקרט	B: שליט יחיד, רודן <br>
אוטוריטה	B: סמכות <br>
אוטרקיה	B: מצב של משק המספק לעצמו את צרכיו <br>
אוליגרכיה	B: משטר מדיני שבו שולט מיעוט <br>
אומדן	B: הערכה <br>
אומניפוטנטי	B: כל יכול <br>
אומצה	B: סטייק <br>
און	B: כוח <br>
אונגרד	B: חלוץ, חדשני <br>
אונגרדי	B: מקדים את זמנו, נועז <br>
אונה	B: חלק מאיבר בחי או בצומח <br>
אוניברסאלי	B: עולמי, כללי <br>
אונקיה	B: יחידת משקל <br>
אופורטוניזם	B: סתגלנות, פשרנות אידיאולוגית <br>
אופטימאלי	B: מיטבי, הטוב ביותר <br>
אופן	B: גלגל <br>
אופן חמישי	B: כינוי לדבר מיותר <br>
אופנסיבה	B: מתקפה <br>
אופרטיבי	B: מבצעי <br>
אוצר	B: אוסף, שומר <br>
אוצר בלום	B: אוצר גדול; אדם בעל ידיעות רחבות <br>
אור יקרות	B: אור נעים <br>
אורבאני	B: עירוני <br>
אורגניזם	B: יצור חי <br>
אורו עיניו	B: התמלא חיים, שמח <br>
אורח	B: דרך, אופן <br>
אורחה	B: שיירה <br>
אורחו וריבועו	B: דרכו ומינהגו, האופן בו אדם מתנהג <br>
אורטור	B: נואם <br>
אוריינטציה	B: חוש כיוון, יכולת התמצאות <br>
אורים ותומים	B: מקור מוסמך שאין לערער עליו, סמכות עליונה <br>
אורלוגין	B: שעון קיר <br>
אורתודוכסי	B: שמרן; דתי אדוק <br>
אושיה	B: יסוד, בסיס <br>
אות קין	B: בושה שאין למחותה <br>
אותיות של טל ומטר	B: אותיות קטנות מאוד <br>
אותיות של קידוש לבנה	B: אותיות גדולות מאוד <br>
אותנטי	B: אמיתי, מקורי <br>
אזוטרי	B: ידוע למעטים, סודי <br>
אזור	B: חגורה, אבנט <br>
אזר	B: קשר חגורה סביב מותניו <br>
אזר חלציו	B: התחזק <br>
אח	B: תנור<br>
אח	B: תנור <br>
אחד בפה ואחד בלב	B: צביעות <br>
אחז את החבל בשני קצותיו	B: ניסה להרוויח משני דברים מנוגדים <br>
אחז את השור בקרניו	B: ניגש ללב העניין <br>
אחז בקרנות המזבח	B: תפס מחסה, ביקש מפלט <br>
אחיזת עיניים	B: תרמית <br>
אחרי המבול	B: לא איכפת לי <br>
אחרית	B: סוף, קץ <br>
אחריתו מי ישורנה	B: אין יודע מה יקרה <br>
אטב	B: מהדק נייר; מהדק להידוק כביסה לחבל <br>
אי אפשר לבר בלא תבן	B: גם בדבר טוב יש פגמים <br>
איבד את העשתונות	B: התבלבל, נבוך <br>
איד	B: צרה, אסון <br>
אידיליה	B: שלווה, הרמוניה <br>
אידרה	B: עצם של דג <br>
איוולת	B: שטות <br>
איושה	B: רחש קל <br>
איזמל	B: מפסלת צרה; סכין לניתוחים <br>
איחוי	B: חיבור, תפירה <br>
איטר	B: שמאלי <br>
איטר יד ימינו	B: שמאלי <br>
איכול	B: בעירה, שריפה <br>
איל	B: כוח, גבורה <br>
אילוח	B: זיהום, אינפקציה <br>
אילולא	B: אילו לא, אם לא <br>
אילוסטרציה	B: איור; הדגמה <br>
אילני סרק קולם הולך	B: טיפש המרבה להתרברב <br>
אילפס	B: מחבת עמוקה, סיר קטן ועמוק <br>
אימום	B: תבנית של כף רגל או גוף <br>
אימננטי	B: פנימי; מהותי <br>
אימפולסיבי	B: מונע על ידי דחפים <br>
אימפרוביזציה	B: אלתור <br>
אימץ את ידיו	B: עודד אותו, דרבן אותו <br>
אימתי	B: מתי <br>
אין אונים	B: חולשה מוחלטת, ריפיון <br>
אין בו מתום	B: מוכה ופצוע; מושלם לחלוטין <br>
אין בליבו עליו	B: אינו כועס עליו <br>
אין הנחתום מעיד על עיסתו	B: אדם אינו יכול לחוות דעה על מעשיו שלו <br>
אין לו אח ורע	B: אין דומה לו, אין כדוגמתו <br>
אין מנוס	B: אין ברירה <br>
אין נביא בעירו	B: כינוי לאדם שאינו זוכה להערכה בסביבתו <br>
אין נקי	B: איש אינו פטור, בלי יוצא מן הכלל <br>
אין סכין מתחדדת אלא בירכי חברתה	B: לימוד בצוותא משפר את הלמידה <br>
אין סתרו כגילויו	B: צבוע <br>
אין עליו עוררין	B: אין התנגדות, אין חולק <br>
אין עשן בלא אש	B: אין דבר ללא סיבה <br>
אין תוכו כברו	B: צבוע <br>
אינדוקציה	B: לימוד מהפרט אל הכלל, הקשה מפרטים רבים אל הכלל המאחד אותם <br>
אינדיקטור	B: מדד, אמת מידה <br>
אינהרנטי	B: פנימי, טבוע <br>
אינטגרלי	B: כולל, שלם <br>
אינטנסיבי	B: מרוכז, מאומץ <br>
אינטראקציה	B: יחסי גומלין <br>
אינטרפרטציה	B: פירוש, פרשנות <br>
אינפוף	B: דיבור כשהאף סתום <br>
אינקוגניטו	B: בעילום שם, אנונימי <br>
אינרציה	B: התמדה; שיגרה <br>
איסוך	B: כד לשמן <br>
איסטניס	B: אנין, מעודן <br>
איספלנית	B: פלסטר, תחבושת <br>
איסתרא בלגינא קיש קיש קריא	B: טיפש המרבה להתרברב <br>
איפה ואיפה	B: אפליה <br>
איפכא מסתברא	B: ההיפך הוא הנכון <br>
איצטבה	B: מדף <br>
איקונין	B: תמונה, דמות <br>
איש אשכולות	B: אדם הבקי בנושאים רבים <br>
איש מדון	B: בעל נטייה לריב, מסוכסך עם הבריות <br>
איש מידות	B: ענק; אדם מעולה במידותיו או במעשיו <br>
איש צפרדע	B: צוללן <br>
אישוש	B: ביסוס, חיזוק <br>
אישקוקה	B: שחמט <br>
אישרור	B: אישור נוסף <br>
איתן	B: יציב, חזק <br>
איתן בדעתו	B: משוכנע לחלוטין בצדקתו <br>
איתרא מזלו	B: הדברים היו לרעתו, ביש מזל <br>
איתרע מזלו	B: לא הלך לו, ביש מזל <br>
אכיפה	B: כפייה <br>
אכסדרה	B: מסדרון <br>
אכסיומה	B: הנחת יסוד שלא ניתן להוכיחה <br>
אלחוש	B: הרדמה <br>
אמרה	B: פתגם; שולי האריג <br>
בא בדברים	B: נושא ונותן <br>
בא בימים	B: זקן <br>
בא כוח	B: נציג מטעמו <br>
בא כחטף	B: בא לפתע; התקיף פתאום <br>
בא על שכרו	B: קיבל את השכר המגיע לו <br>
בא עליו במקלו ובתרמילו	B: תקף אותו בלהט הויכוח <br>
באו לעמק השווה	B: הסכימו, התפשרו <br>
באו מים עד נפש	B: נמאס, עד קצה גבול היכולת <br>
באוש	B: מסריח <br>
באותות ומופתים	B: באופן משכנע באמצעות הוכחות <br>
באיבו	B: בצעירותו <br>
בבאת עין	B: דבר חשוב ויקר <br>
בבואה	B: דמות המשתקפת במים או במראה <br>
בגדי שרד	B: מדים רשמיים <br>
בלדר	B: שליח <br>
במטותא	B: בבקשה <br>
בן בליעל	B: רשע, נבל <br>
בן כילאיים	B: צאצא של צמחים או בע"ח מזנים שונים <br>
בעידנא דריתחא	B: בשעת כעס <br>
בעלמא	B: סתם <br>
בעלת איברים	B: אישה בעלת איברים מגודלים <br>
בער	B: חסר השכלה <br>
בערוב ימיו	B: בסוף ימיו <br>
בקירוב	B: בערך, לא במדויק <br>
בר אוריין	B: בן תורה, תלמיד חכם <br>
בר בי רב	B: תלמיד <br>
בר סמכא	B: מומחה <br>
בר פלוגתא	B: יריב, בעל מחלוקת <br>
בר קיימא	B: יציב, מתקיים לאורך זמן <br>
בראש חוצות	B: בגלוי <br>
ברחל בתך הקטנה	B: תנאי מפורש וברור <br>
ברי	B: ברור, שאינו מוטל בספק <br>
בריח	B: מוט לנעילת הדלת <br>
בריקדה	B: מחסום <br>
ברכה לבטלה	B: טירחה המושקעת לחינם <br>
גבבה	B: פסולת, דבר נטול ערך <br>
גבה הר ביניהם	B: רבו, הסתכסכו <br>
גבה ליבו	B: התגאה, התרברב <br>
גבין	B: גבה <br>
גביר	B: אדון, אדם חשוב <br>
גבנון	B: כינוי לעקמומיות הגב <br>
גבר	B: תרנגול <br>
גברא רבא	B: אדם חשוב <br>
גברתן	B: חזק <br>
גד	B: מזל, אושר <br>
גדה	B: שפת הנהר <br>
גדוש	B: מלא לגמרי, עמוס <br>
גדיד	B: קטיף תמרים <br>
גדיל	B: קווצת חוטים היוצאת מן השוליים <br>
גדיש	B: ערמת תבואה שנקצרה <br>
גדם	B: קטע, כרת <br>
גדע	B: קטע, כרת <br>
גדש	B: צבר, מילא יותר מדי <br>
גדש את הסאה	B: עבר את הגבול, הגזים <br>
גהה	B: רפואה, בריאות <br>
גהות	B: היגיינה <br>
גהר	B: התכופף <br>
גו	B: גוף, תוך <br>
גו	B: גוף, תוך <br>
גוב	B: בור, מאורה <br>
גוב אריות	B: מקום מסוכן <br>
גוויל	B: דף מספר עתיק <br>
גוזמאי	B: מספר סיפורים מופרזים ושקריים <br>
גוזמה	B: תאור מופרז, הגזמה <br>
גוחך	B: מגחך, מחייך <br>
גוחך	B: מגחך, מחייך <br>
גולל	B: אבן לכיסוי הפתח; פירש <br>
גולם	B: חרק <br>
גולמי	B: שאינו מעובד <br>
גולמי	B: שאינו מעובד <br>
גומה	B: שקע, חור <br>
גומחה	B: שקע <br>
גוץ	B: נמוך <br>
גור	B: היזהר <br>
גושפנקה	B: חותם, אישור רישמי <br>
גושר	B: בונה גשרים; מתגבר על מחלוקות <br>
גז	B: נעלם והתפוגג; צמר שנגזז <br>
גזוזטרה	B: מרפסת <br>
גזילה	B: שוד, לקיחת דבר בכוח <br>
גזיר	B: חתיכה, פיסה <br>
גזירה	B: פקודה שיש בה איסור <br>
גזרה שווה	B: השוואה בין צדדים שונים על סמך הדמיון ביניהם <br>
גחון	B: בטנם של בע"ח <br>
גחמה	B: עיקשות, דחף יצרי <br>
גחן	B: התכופף <br>
גיבב	B: שם בערמה ללא סדר <br>
גיבב דברים	B: דיבר הרבה ללא צורך ומסר <br>
גיבן	B: שגבו מעוקם <br>
גידם	B: שידו קטועה עד למרפק <br>
גידע	B: שידו קטועה עד לכתף <br>
גידף	B: קילל <br>
גיל	B: שמחה, ששון <br>
גילדה	B: איגוד בעלי מקצוע <br>
גילה טפח וכיסה טפחיים	B: העלים יותר משגילה <br>
גילופין	B: מצב של שיכרות קלה <br>
גימלה	B: תשלום קבוע הניתן כזכות על עשייה בעבר <br>
גינה	B: ציין לשלילה <br>
גינה	B: קילל <br>
גינונים	B: נימוסים <br>
גינזך	B: ארכיון <br>
גיס חמישי	B: כינוי לבוגדים מבית <br>
גירגור	B: שטיפת הגרון; השמעת קול נמוך <br>
גירסא דינקותא	B: הידע שצבר אדם בשנותיו הראשונות <br>
גלמוד	B: בודד <br>
גלעין	B: חרצן <br>
גלקסיה	B: מערכת כוכבים <br>
גמא דרך	B: הלך מרחק רב <br>
גמלה	B: תשלום קבוע הניתן כזכות על עשייה בעבר <br>
גנב את דעתו	B: רימה אותו <br>
גנב את ליבו	B: רימה אותו <br>
גנוז	B: נסתר, חבוי <br>
גנזך	B: ארכיון <br>
גסטרונומיה	B: אומנות הבישול <br>
געה	B: השמיע קול <br>
געה בבכי	B: בכה וילל <br>
געה בצחוק	B: פרץ בצחוק גדול <br>
גער	B: נזף <br>
געש	B: נסער, נרגז <br>
גפה	B: חוץ; החלק בנעל שבשוליו השרוכים <br>
גפיים	B: הידיים והרגליים בבני האדם <br>
גפיר	B: שומר, שוטר <br>
גץ	B: ניצוץ, שביב אש <br>
גר	B: אדם שהמיר דתו ליהדות; אדם בארץ זרה <br>
גרביטציה	B: כוח הכבידה <br>
גרגרן	B: זללן <br>
גרדום	B: מתקן לעריפת ראשים <br>
גרוגרת	B: תאנה מיובשת <br>
גרוטסקי	B: מגוחך, מוגזם עד לכדי גיחוך <br>
גשם זלעפות	B: גשם כבד וסוער <br>
גשם נדבות	B: גשם היורד בעיתו ובשפע <br>
גשמי	B: חומרי, גופני <br>
גת	B: בור לדריכת ענבים ליין <br>
ד אמות	B: מקום מצומצם, סביבתו הקרובה של האדם <br>
דא עקא	B: זו הצרה, הצרה היא <br>
דאבה	B: צער ודאגה <br>
דאבון	B: כאב, צער <br>
דאון	B: כלי טיס ללא מנוע <br>
דאייה	B: ריחוף באוויר <br>
דבוקה	B: צרור של פצצות או צנחנים <br>
דבלה	B: תאנה מיובשת <br>
דבלול	B: קצה חוט היוצא מן אריג <br>
דבקה לשונו לחיכו	B: שתק <br>
דבר אל העצים ואל האבנים	B: אין עונה <br>
דבר דבור על אופניו	B: דבר מסודר מפורט וברור <br>
דבר של מה בכך	B: עניין לא חשוב <br>
דברי חלקות	B: חנופה <br>
דחוק	B: לחוץ; לא משכנע <br>
דחי	B: כישלון, תקלה <br>
דחף	B: חשק פתאומי לעשות משהו <br>
דחק את הקץ	B: לחץ לסיים מתוך קוצר רוח <br>
דחק את השעה	B: מיהר מדי, נחפז <br>
דחק את רגליו	B: תפס את מקומו <br>
דטרמיניזם	B: אמונה כי הכול קבוע מראש ללא אפשרות שינוי <br>
די לחכימא ברמיזה	B: ניתן להסתפק ברמיזה <br>
דיאגנוסטי	B: מאבחן, בודק מחלה או הרכב חומרים <br>
דיאלקט	B: הלשון המדוברת באזור מסוים <br>
דיבה	B: דברי גנאי, רכילות <br>
דיבידנד	B: רווח המחולק בין שותפים או בעלי מניות <br>
דיבר סרה	B: ציין דברים שליליים <br>
דיבר על ליבו	B: ניסה לפייסו; ניסה לשכנעו <br>
דיבשה	B: נוזל מתוק שנוצר מהפקת סוכר <br>
דיסקרטי	B: סודי, חסוי <br>
דיפון	B: חיזוק דפנות הבור <br>
דיפרסיה	B: דיכאון <br>
דיפתר	B: פנקס, מחברת <br>
דיצה	B: שמחה, ששון <br>
דיקדוקי עניות	B: קפדנות מוגזמת <br>
דיקדק	B: הקפיד על כל פרט, בדק בעיון <br>
דיקדק עימו כחוט השערה	B: לא ויתר לו, נהג איתו בקפדנות רבה <br>
דיקטטור	B: שליט יחיד <br>
דיקטטורה	B: שלטון יחיד או קבוצה מצומצמת <br>
דירבון	B: עידוד לעשות משהו, זירוז <br>
דירקטוריון	B: מועצת מנהלים <br>
דירת שרד	B: מעון רשמי של בעל תפקיד <br>
דישדש	B: צעד במקום; דרך ברגליו <br>
דכי	B: קול התנפצות הגלים <br>
דל	B: עני, חסר כל <br>
דלה	B: שאב, הוציא <br>
דלוח	B: לא צלול, מלוכלך <br>
דלעיל	B: שהוזכר קודם, שמופיע מעלה <br>
דלפון	B: עני, חסר כל <br>
דלק	B: רדף, רץ אחרי <br>
דלקה	B: שרפה <br>
דלת העם	B: העניים, השכבות הנמוכות בחברה <br>
דם כחול	B: כינוי לבעל מוצא מיוחס <br>
דמגוג	B: בעל יכולת מילולית גבוהה, בעל כוח שכנוע <br>
דמו בראשו	B: נושא באחריות; ראוי להיהרג כעונש <br>
דמוגרפיה	B: חוקר הרכב האוכלוסייה ושינוייה <br>
דמוני	B: שטני <br>
דמי	B: שקט, דממה <br>
דמי ימיו	B: באמצע חייו, במיטב שנותיו <br>
דמי לא יחרץ	B: שוחד <br>
דמים	B: כסף <br>
דרדס	B: נעל בית, סנדל <br>
דרדק	B: ילד <br>
דרדר	B: סוג של קוץ <br>
דרוך	B: מתוח, מוכן <br>
דריסת רגל	B: כניסה לרשותו של אחר, התפרצות לשטח פרטי <br>
דרך	B: מתח; דרס <br>
דרך ארץ	B: נימוסים, התנהגות טובה <br>
דרך הישר	B: התנהגות נאותה, כינוי לצורה שיש להתנהג כמותה <br>
דרך המלך	B: הדרך הראשית <br>
דרך חתחתים	B: דרך מלאה במכשולים <br>
דרך כוכבו	B: הצליח <br>
דרסטי	B: תקיף; קיצוני <br>
דרקוני	B: קשה וחמור ביותר, אכזרי <br>
דרש	B: הפירוש המעמיק והחקרני למקרא <br>
דרש	B: פירש <br>
דרשה	B: הרצאה שעיקרה פרשנות של טקסט <br>
האנשה	B: ייחוס תכונות אנושיות לבע"ח ודוממים <br>
הבל	B: קיטור; שטות <br>
הבלי העולם	B: כינוי למותרות ועניינים חסרי חשיבות <br>
הבליג	B: התאפק <br>
הבליח	B: נצנץ, האיר לסירוגין <br>
הגהה	B: בדיקה ותיקון טעויות כתיב <br>
הגות	B: מחשבה, הרהורים <br>
הגיגים	B: הרהורים, מחשבות <br>
הגיח	B: צץ לפתע, התפרץ <br>
הגיע לפירקו	B: הגיע זמנו להינשא <br>
הגיע עד צוואר	B: הגיע לקצה יכולתו <br>
הגיעו מים עד נפש	B: אין יכולת לשאת זאת יותר <br>
הגיף	B: סגר, נעל <br>
הגליד	B: נרפא <br>
הגמוניה	B: שלטון, שליטה <br>
הגעלה	B: טבילת כלים במים רותחים <br>
הפיך	B: שאפשר להפוך אותו; שניתן להחזירו לאחור <br>
הפיל חיתתו	B: הפחיד אותו <br>
הפיס את דעתו	B: פייס, ריצה <br>
הפך את היוצרות	B: בילבל, בילגן <br>
הפך קערה על פיה	B: שינה דבר באופן יסודי, שינה אותו לחלוטין <br>
הפליג	B: הרחיק; הגזים <br>
הפנמה	B: הכנסה פנימה <br>
הפקעה	B: הוצאה מידי אחרים <br>
הפקעת מחיר	B: העלאה מוגזמת של המחיר, העלאה לא סבירה של המחיר <br>
הפרטה	B: מכירה של רכוש ציבורי לבעלות פרטית <br>
הציף	B: מילא מעל ומעבר; גרם לו לצוף <br>
הציץ ונפגע	B: נחשף למשהו שלא היה מוכן אליו <br>
הצמית	B: השמיד, הכחיד <br>
הצפין	B: הסתיר; הלך צפונה <br>
הצר צעדיו	B: הפריע לו, ניסה להכשיל אותו <br>
הקדחה	B: שריפה, חריכה <br>
הקדיח את תבשילו	B: התעסק עיסוק מיותר בעניין כלשהו עד להריסתו <br>
הקדים רפואה למכה	B: צפה ומנע בעיה מראש <br>
הקיז	B: התיז דם, הוציא דם <br>
הקיץ	B: התעורר, קם משינה <br>
הקיץ הקץ	B: הגיע הסוף, בא סופו <br>
הקניט	B: הכעיס, הרגיז <br>
הקצאה	B: ייעוד למטרה מסוימת <br>
הקשה את ליבו	B: סירב לסלוח או לוותר <br>
הראהו נחת זרועו	B: הכה אותו מכות נמרצות, הרביץ לו מכות נמרצות <br>
הרביץ תורה	B: הרצה, לימד <br>
הרהיב עוז בנפשו	B: העז <br>
הרים מעפר	B: שיקם, קומם <br>
הרים ראש	B: התמרד, התקומם <br>
הרך הנולד	B: כינוי לתינוק שרק נולד <br>
הרמוניה	B: התאמה <br>
הרמטי	B: אטום <br>
הרעיף	B: טפטף; הירבה <br>
הרף	B: הפסק, הנח <br>
הרצין	B: נעשה רציני <br>
הרשיע	B: חייב בדין, גזר דין לחיוב <br>
השאה	B: פיתוי, הסתה <br>
השאת עצה	B: מתן עצה, ייעוץ <br>
התגודדו	B: נאספו, התקבצות אל אנשים רבים <br>
התגושש	B: נאבק <br>
התגושש	B: נאבק <br>
התגלע	B: התלקח, התפרץ <br>
התדפק על דלתו	B: ניסה להיכנס למקום מסוים <br>
התהדר	B: התקשט, התייפה <br>
התודעות	B: הכרות <br>
התזה	B: כריתה; הזלפה <br>
התחבט	B: התלבט <br>
התחמם כנגד אורו	B: למד מחוכמתו והתנהגותו של אדם קרוב אליו <br>
התחמץ לבב	B: הצטער <br>
התחסדות	B: צביעות <br>
התחקות	B: חיפוש אחרי, הליכה בעקבות <br>
התחשרות	B: התקבצות, התעבות <br>
התיז	B: כרת; טפטף <br>
התייפח	B: בכה בכי מר <br>
התיר	B: איפשר; שיחרר <br>
התכתש	B: נאבק <br>
התלהם	B: השתולל <br>
התלקח	B: נדלק; התעורר והתחזק <br>
התמוגג	B: התענג, היה שבע רצון <br>
התנגח	B: נאבק <br>
התנהל	B: התקדם, התהלך <br>
התנופף	B: זז ברוח, זז ברוח מצד לצד <br>
התפלמס	B: התווכח <br>
התפלש	B: התגלגל בתוך <br>
התפקר	B: עזב את הדת <br>
התפרדה החבילה	B: נפסק הקשר <br>
התפרץ לדלת פתוחה	B: הציג עניין שאין לו מתנגדים ולכן אין צורך להציגו, הביע טענה שכולם מסכימים לה בלאו הכי <br>
התפשט כאש בשדה קוצים	B: התפשט במהירות <br>
התקה	B: הסטה, הזזה <br>
התקהלות	B: התקבצות של אנשים רבים, נאספו <br>
התרועע	B: התחבר, התיידד <br>
התריס	B: התנגד, הביע מחאה <br>
התרעם	B: כעס, רגז <br>
התרפס	B: התחנף <br>
התרפק	B: נשען מתוך התפנקות ואהבה על מישהו <br>
התרפק	B: נשען מתוך התפנקות ואהבה על מישהו <br>
התרצה	B: הסכים לבסוף, נענה בחיוב <br>
התרצה	B: הסכים לבסוף, נענה בחיוב <br>
התרת רסן	B: נתינת חופש מוחלט <br>
התרת רסן	B: נתינת חופש מוחלט <br>
ואידך זיל גמור	B: זה העיקר <br>
ואידך זיל גמור	B: זה העיקר <br>
וולגרי	B: המוני, גס <br>
וולונטרי	B: התנדבותי, נעשה מרצון <br>
וולקני	B: שמוצאו מהר געש <br>
וטו	B: סמכות היחיד לבטל חוק כנגד דעת הרוב <br>
ויברציה	B: רטט, תנועה מהירה מאוד <br>
ויזה	B: רישיון להיכנס למדינה, אשרת כניסה <br>
ויזואלי	B: חזותי <br>
ויטאלי	B: חיוני ושופע חיים <br>
וירטואוז	B: אמן בעל שליטה מופלאה <br>
וישמן ישורון ויבעט	B: התנהג בכפיות טובה <br>
ולא נודע כי בא אל קירבו	B: לא ניכר בו כל שינוי, לא השתנה בכלל <br>
ולד	B: תינוק <br>
ונדאלי	B: פראי, ברברי <br>
וריאציה	B: שינוי, נוסח שונה <br>
ותו לא	B: ולא עוד, וזהו <br>
ז'אנר	B: סגנון <br>
ז'רגון	B: אוסף ביטויים ומונחים הייחודי לקבוצת אנשים, אוסף ביטויים ומונחים הייחודי לתחום מסוים <br>
זאב בעור כבש	B: צבוע, מעמיד פנים <br>
זאטוט	B: ילד קטן, תינוק <br>
זב	B: נזל <br>
פיקטיבי	B: מדומה, שקרי <br>
פיקנטי	B: מעורר עניין; שטעמו חריף <br>
פיר	B: בור, גומה <br>
פירזול	B: ייצור ועיצוב אביזרים מברזל; הצמדת פרסות ברזל לרגלי הסוס <br>
פירכס	B: רטט; התאפר <br>
פיתום	B: אדם המדבר מהבטן <br>
פך	B: כלי קטן לנוזלים <br>
פכים קטנים	B: כינוי לדברים קטנים <br>
פכית	B: צנצנת <br>
פכסום	B: גריסה; קולות נגיסה באוכל יבש <br>
פלומה	B: החלק הרך והשעיר בנוצה; השערות הראשונות בגוף <br>
פלוני	B: זהותו אינה ידועה <br>
פלורליזם	B: קבלת מגוון דעות ואנשים <br>
פלוש	B: מסדרון <br>
פלחה	B: עבודת אדמה העוסקת בגידול תבואות השדה <br>
פלך	B: אזור; קנה שעליו מלפפים צמר <br>
פלמוני	B: זהותו אינה ידועה <br>
פלס	B: מאזניים <br>
פלסתר	B: רמאות, זיוף <br>
פלצור	B: חבל שבקצהו לולאה ללכידת חיות <br>
פלצות	B: רעד, זעזוע <br>
פצח	B: פתח <br>
פציפיסט	B: שוחר שלום, מתנגד למלחמה ולשפיכות דמים <br>
פצירה	B: כלי לשיוף והחלקה <br>
פקד	B: ציווה; ספר <br>
פקד את ביתם	B: ערך ביקור בביתם <br>
פקיר	B: נזיר החיי חיי דלות והתנזרות <br>
פקע	B: נשבר, נסדק <br>
פקעה סבלנותו	B: לא יכול היה לסבול זאת יותר <br>
פרברי העיר	B: שכונות בקצה העיר <br>
פרברים	B: אזורי המגורים שבשולי העיר <br>
פרגוד	B: וילון, מסך <br>
פרגול	B: שוט <br>
פרובינציה	B: עיר קטנה הרחוקה ממרכזי התרבות במדינה <br>
פרודה	B: מולקולה <br>
פרודוקטיבי	B: יצרני, מועיל <br>
פרודיה	B: חיקוי לעגני ליצירה אחרת <br>
פרוזאי	B: ענייני <br>
פרוזה	B: ספרות כתובה ללא משקל וחריזה <br>
פרוטוטייפ	B: דוגמה ראשונית <br>
פרולוג	B: הקדמה, פתיחה <br>
פרולטריון	B: מעמד הפועלים <br>
פרופורציה	B: יחס, התאמה <br>
פרופיל	B: מראה מהצד <br>
צ'רטר	B: כתב זכויות; טיסת שכר <br>
צבא	B: התאסף, התקהל <br>
צבה	B: התנפח <br>
צביון	B: דמות, אופי <br>
צביר	B: קבוצת חפצים <br>
צבר	B: ערימה; אסף <br>
צג	B: מסך <br>
צורר	B: שונא, אויב <br>
צח	B: טהור, נקי <br>
צחור	B: לבן <br>
צחות לשון	B: שימוש בשפה יפה <br>
צחיח	B: יבש <br>
צחנה	B: סירחון <br>
צחצוח חרבות	B: ויכוח סוער <br>
צחצוח מילים	B: ויכוח סוער <br>
ציבור	B: אוסף; קהל <br>
צידד	B: הפנה הצידה; תמך <br>
ציה	B: מדבר, שממה <br>
ציויליזציה	B: תרבות <br>
ציטטה	B: ציטוט, קטע הלקוח מתוך טקסט או התבטאות כלשהי <br>
צינה	B: קור; מגן <br>
צינוק	B: בית כלא, תא צר ואפל המשמש כעונש לאסירים <br>
ציני	B: לועג למקובל <br>
ציפה	B: בשר הפרי <br>
ציפור הנפש	B: החלק הרגיש והיקר ביותר <br>
ציפורן	B: הקצה המתכתי של עט <br>
ציפחה	B: מחצב המתפצל לשכבות <br>
ציץ	B: עלי הכותרת בפרח <br>
ציצית	B: קווצת שערות או חוטים <br>
ציקלון	B: תרמיל; סופה גדולה וחזקה <br>
ציקלופ	B: ענק אגדי בעל עין אחת במרכז המצח <br>
ציקן	B: קמצן <br>
ציר	B: כאב; קו התקדמות <br>
ציתות	B: הקשבה, האזנה <br>
צלח	B: חצה, הגיע מקצה לקצה <br>
צלחה דרכו	B: הצליח <br>
צליין	B: עולה לרגל, מבקר במקומות הקדושים לדתו <br>
צלם	B: דמות, צורה <br>
צרוב	B: נשרף, נכווה <br>
צרוף	B: טהור, נקי <br>
צרור	B: חבילה <br>
צרות מוחין	B: טיפשות <br>
צרות עין	B: קינאה, קושי לראות אחרים מצליחים <br>
צרי	B: תרופה <br>
צריח	B: מגדל צר המזדקר בתוך מבנה גדול <br>
צרר	B: קשר; הציק <br>
קב ונקי	B: קטן ואיכותי, כמות מועטה אך באיכות טובה <br>
קורקטי	B: הוגן, ראוי <br>
קורת רוח	B: הנאה, שביעות רצון <br>
קושן	B: תעודת רישום של קרקע <br>
קושש	B: אסף <br>
קזוס בלי	B: סיבה מוצדקת למלחמה <br>
קטגורי	B: מכריע, מוחלט <br>
קטום	B: שנכרת ראשו <br>
קטליזאטור	B: מזרז, זרז <br>
קיבורת	B: שריר הזרוע <br>
קיבעון	B: היצמדות מופרזת לאדם או לחפץ <br>
קמטר	B: ארונית, שידה <br>
קמילה	B: נבילה <br>
קמין	B: תנור <br>
קנה במשיכה	B: גנב <br>
קנה עולמו	B: זכה להצלחה רבה <br>
קנה רצוץ	B: כינוי לאדם שאי אפשר לסמוך עליו <br>
קנה שביתה	B: התיישב במקום קבוע <br>
ראה צל הרים כהרים	B: פחד בלי שום סיבה, פחד בלתי מוצדק <br>
רבב	B: כתם שמן; פגם מוסרי <br>
רבבה	B: עשרת אלפים <br>
רבותה	B: יתרון <br>
רביב	B: גשם <br>
רביד	B: תכשיט לצוואר; מטפחת לצוואר <br>
רביכה	B: קמח מעורבב בשמן <br>
רגרסיה	B: נסיגה <br>
ריבית קצוצה	B: ריבית מופרזת <br>
רידד	B: שיטח <br>
ריחיים	B: מתקן לטחינת גרגרים <br>
ריחיים בצווארו	B: נתון תחת עול <br>
ריטואל	B: טקס, פולחן <br>
ריטש	B: קרע לגזרים <br>
רימה	B: זחלים של חרקים <br>
רינון	B: שירה; רכילות <br>
ריף	B: סלע בים <br>
ריפוט	B: השחתה מרוב שימוש <br>
רישא	B: החלק הראשון <br>
ריתחא	B: התפרצות של כעס <br>
רך לב	B: פחדן <br>
רך לבב	B: פחדן <br>
רכב	B: עגלון; האבן העליונה בריחיים <br>
רכוס	B: קשור, מכופתר <br>
רכיב	B: חלק, מרכיב <br>
רכיל	B: לשון הרע <br>
רכן	B: התכופף <br>
רעץ	B: שבר, פוצץ <br>
רף	B: מדף <br>
רפה	B: חסר כוח, חלש <br>
רפורמה	B: תיקון יסודי <br>
רפפה	B: נסר דק של עץ <br>
רפרפת	B: פודינג <br>
רפש	B: בוץ, ליכלוך <br>
רץ	B: שליח <br>
רציונאלי	B: הגיוני <br>
רצע	B: דקר וניקב, ניקב חור <br>
רצען	B: סנדלר <br>
רצץ	B: שבר, ניפץ <br>
רקבובית	B: חומר חי שהרקיב <br>
רקוויאם	B: שיר אבל, יצירה מוזיקלית לזכר המת <br>
רקח	B: ערבב <br>
רקיק	B: עוגה שטוחה, צנים <br>
רקע	B: דרך <br>
רקק	B: מקווה מים עכורים; ירק <br>
רש	B: עני, חסר כל <br>
רשף	B: ניצוץ, שביב <br>
רתם את העגלה לפני הסוסים	B: הקדים את המאוחר; הפך את היוצרות <br>
רתת	B: רעד, רטט <br>
שאב מים בכברה	B: עשה עבודה ללא תועלת, עבד ללא תועלת <br>
שאה	B: נחרב, התרוקן <br>
שאוב	B: לקוח <br>
שאון	B: רעש, המולה <br>
שאור שבעיסה	B: החלק העיקרי <br>
שאט	B: בוז, זלזול <br>
שאט נפש	B: סלידה, יחס של בוז <br>
שאיה	B: הרס, חורבן <br>
שאנן	B: לא מודאג, איננו מודאג <br>
שאר בשר	B: קרוב משפחה <br>
שאר רוח	B: עומק מחשבה, מחשבה עמוקה <br>
שבב	B: רסיס, שבריר <br>
שבט	B: מקל; שרביט <br>
שביב	B: ניצוץ; משהו <br>
שביס	B: כיסוי ראש לנשים <br>
שבלוני	B: שגרתי, נדוש <br>
שבק	B: עזב, נטש <br>
שבק חיים	B: מת, נפטר <br>
שבר	B: חלק; בקע <br>
שבר כלי	B: כינוי לאדם חלש וחולני <br>
שברייה	B: חרב קצרה <br>
שבריר	B: רסיס, שבב <br>
שגגה	B: טעות, שגיאה <br>
שגור	B: רגיל <br>
שגיא	B: עצום <br>
שגיב	B: עצום, גדול מאוד <br>
שדוף	B: מיובש; ריק מתוכן <br>
שדמה	B: שדה תבואה או כרם <br>
שובה	B: מתינות, רוגע <br>
שוביניסט	B: קנאי וקיצוני לעמו <br>
שווה לכל נפש	B: מתאים לכל אחד <br>
שווה נפש	B: אדיש <br>
שוועה	B: צעקה, קריאה לעזרה <br>
שוחה	B: בור <br>
שוחר	B: חובב; מבקש <br>
שום	B: מונח, מוטל <br>
שומה	B: הערכה; בליטה בעור <br>
שוע	B: עשיר <br>
שופי	B: בריאות; שפע <br>
שופרא	B: מיטב <br>
שופרא דשופרא	B: המובחר ביותר, המיטב <br>
שושבין	B: חבר, ידיד <br>
שזירה	B: פיתול של חוטים יחד <br>
שזף	B: שרף; הביט <br>
שח	B: התכופף <br>
שח עיניים	B: צנוע <br>
שחה	B: התכופף <br>
שחוח	B: כפוף <br>
שחון	B: חם ויבש <br>
שחל	B: אריה <br>
שחר	B: מובן; דמדומי בוקר <br>
שחת	B: בור, מזון לבהמות <br>
שטם	B: שנא <br>
שי	B: מתנה <br>
שיבוט	B: שם של דג; שכפול גנטי <br>
שיבולת	B: מערבולת <br>
שיבכה	B: רשת <br>
שיג	B: עניין, צורך <br>
שיג ושיח	B: משא ומתן <br>
שיגיון	B: תחביב; להיטות <br>
שידד	B: פורר את הקרקע <br>
שידה	B: ארון נמוך <br>
שידוד מערכות	B: שינוי קיצוני <br>
שידפון	B: מכת יובש בצמחים; ריקנות <br>
שיהוי	B: עיכוב; הפסקה קלה <br>
שיחת זמנו לריק	B: בזבז זמן <br>
שיטנה	B: דברי האשמה וגנאי <br>
שייר	B: שארית <br>
שיית	B: סוג של קוץ; יסוד <br>
שיכוך	B: הרגעה <br>
שיכול	B: שינוי הסדר, החלפה <br>
שינוס	B: חגירה, קשירה <br>
שינס	B: חגר <br>
שינס מותניו	B: התכונן במרץ <br>
שינץ	B: חיבר, קשר <br>
שיסה	B: הסית <br>
שיסוף	B: קריעה <br>
שיסף	B: קרע <br>
שיעבוד	B: עבדות, כיבוש <br>
שיעור	B: מידה, כמות <br>
שיערוך	B: הערכה מחודשת <br>
שיעתוק	B: העתק של יצירה מקורית <br>
שיפוי	B: החלקה; פיצוי <br>
שיפול	B: תחתית; שוליים <br>
שיפון	B: אחד ממיני התבואה <br>
שיפחה	B: משרתת <br>
שיפרה	B: יופי, חן <br>
שיקוץ	B: תועבה, מאוס <br>
שירות דוב	B: כוונה טובה המובילה דווקא לנזק <br>
שירש	B: עקר מהשורש <br>
שכב	B: האבן התחתונה בריחיים <br>
שכווי	B: תרנגול <br>
שכיב מריע	B: גוסס, נוטה למות <br>
שכיות חמדה	B: דבר יפה ויקר ערך <br>
שכיח	B: מצוי ורגיל <br>
שכייה	B: קישוט <br>
שכך	B: נרגע, נח <br>
שלג דאשתקד	B: דבר שעבר ואין זוכרים אותו, דבר שאינו מעניין עוד <br>
שלה	B: הוציא מהמים <br>
שלהי	B: סוף <br>
שלוק	B: מבושל במים חמים <br>
שלח	B: חרב קצרה; תעלה להשקיה <br>
שלח יד	B: גנב; עסק במקצוע מסוים <br>
שלח יד בנפשו	B: התאבד, שם סוף לחייו <br>
שלח לחמך על פני המים	B: עשיית טובות גם ללא תגמול מיידי <br>
שלחופה	B: צב <br>
שלמה	B: שמלה, בגד רחב <br>
שלף	B: שדה שנקצר אך עוד לא נחרש <br>
שלק	B: הרתיח במים, בישל במים רותחים <br>
שם לאל	B: שלל, הכשיל <br>
שם נפשו בכפו	B: הסתכן <br>
שם פעמיו	B: יצא לדרך <br>
שמורה	B: עפעף <br>
שמיטה	B: עזיבה, ויתור <br>
שמיר	B: שיח קוצני; אבן חזקה וקשה <br>
שמיר ושיית	B: שממה <br>
שמלנית	B: שמלה חצאית <br>
שמנה וסלתה	B: הטובים והנבחרים <br>
שמץ	B: קצת, מעט <br>
שנה	B: למד; עשה דבר שוב <br>
שנון	B: חד; חריף וקולע <br>
שני	B: אדום עז <br>
שניוני	B: ממדרגה שנייה <br>
שנף	B: וניל <br>
שנץ	B: רצועה, שרוך <br>
שנק	B: חניקה, מחנק <br>
שנת אור	B: המרחק שעוברת קרן אור בשנה <br>
שנתות	B: סימנים במרחקים זהים למדידת כמות <br>
שעה	B: שם לב, הקשיב <br>
שעטה	B: דריכה חזקה, צעידה חזקה <br>
שעטנז	B: ערבוב מין בשאינו מינו <br>
שעייה	B: פנייה, נטייה <br>
שעיר	B: תייש <br>
שעל	B: צעד; חופן <br>
שפאים	B: שבבים העפים בשיוף עץ <br>
שפוף	B: כפוף <br>
שפיר	B: יפה, נאה <br>
שפך על פניו קיתונות של בוז	B: העליב, השמיץ <br>
שפע	B: נתן הרבה <br>
שפת	B: שם על האש <br>
שצף	B: זרם חזק, זרם בכוח <br>
שקט על שמריו	B: לא עשה דבר, לא גדל <br>
שקיקה	B: חשק חזק, תשוקה <br>
שקלא וטרייא	B: משא ומתן <br>
שקעה שימשו	B: ירד מגדולתו, השפעתו פסקה <br>
שקר אין לו רגליים	B: סופו של השקר להתגלות <br>
שרג	B: סיבך, שילב <br>
שרד	B: שירות, פקידות <br>
שרירות	B: עקשנות ללא הגיון <br>
שרלטן	B: נוכל, מתחזה <br>
שרעף	B: מחשבה, הירהור <br>
שרף	B: מלאך; נחש ארסי <br>
שררה	B: שלטון, ממשל <br>
שרש	B: עקר, השמיד <br>
שש	B: שמח <br>
שת	B: הניח; טוסיק <br>
שתדלן	B: משתדל לטובת אחרים <br>
שתת	B: נשפך; הזיל <br>
תאב	B: רוצה, משתוקק <br>
תבל	B: עולם, יקום <br>
תגרן	B: מוכר; כינוי למרבה להתווכח <br>
תהה על קנקנו	B: בדק את טיבו, בחן <br>
תהום הנשייה	B: שיכחה מוחלטת <br>
תואנה	B: תירוץ; אשמת שקר <br>
תוגה	B: עצב <br>
תוהו	B: ריקנות, שממה <br>
תוחלת	B: תקווה, ציפייה <br>
תוכו כברו	B: ישר, כן ואמיתי <br>
תוכחה	B: נזיפה, הטפת מוסר <br>
תוכן	B: אסטרונום <br>
תולדה	B: מסקנה, תוצאה <br>
תופין	B: עוגה <br>
תופת	B: גיהינום; שריפה גדולה <br>
תור	B: תקופה, זמן <br>
תורפה	B: חולשה <br>
תושייה	B: כושר המצאה, חוכמה <br>
תזה	B: הנחת יסוד; מחקר <br>
תזזית	B: שיגעון; רוח חזקה <br>
תחינה	B: תפילה, בקשת רחמים <br>
תחלואה	B: מחלה <br>
תחליב	B: תערובת נוזלים שונים שלא התערבבו לחלוטין זה בזה <br>
תחריט	B: ציור שחקוק במתכת <br>
תיאולוגיה	B: תורת האמונה באלוהים <br>
תיאוקרטיה	B: שלטון הדת <br>
תיבת פנדורה	B: פרשה המהווה מקור לצרות <br>
תיגר	B: ריב, התגרות <br>
תיחוח	B: פירור אדמה יבשה <br>
תיכון	B: אמצעי, נמצא בין לבין <br>
תימסח	B: תנין <br>
תימרה	B: עמוד המורכב חומר ערפילי <br>
תינה	B: סיפר ותיאר מעשה; ספד למת <br>
תינה אהבים	B: קיים יחסי מין <br>
תיעב	B: סלד <br>
תיעול	B: התקנת רשת של תעלות <br>
תירוש	B: יין לפני תסיסה, יין שעדיין לא תסס <br>
תיתורה	B: שוליים <br>
תככים	B: מזימות, סכסכנות <br>
תכריך	B: כיסו למת; חבילה <br>
תל	B: גבעה מלאכותית, ערמה <br>
תלאות	B: צרות וייסורים <br>
תלה את הקולר בצווארו	B: האשים אותו, הטיל עליו את האחריות למעשה <br>
תלה עצמו באילן גדול	B: הסתמך בדבריו על בקיא ממנו <br>
תלוי ועומד	B: מוטל בספק, ממתין להכרעה <br>
תלוי על בלימה	B: לא מבוסס, בלי קשר למציאות <br>
תלי	B: נרתיק לחיצים; קולב לתליית בגדים <br>
תלם	B: חריץ הנעשה במחרשה <br>
תם	B: תמים; נגמר <br>
תמוכה	B: משענת <br>
תמורה	B: תחליף; חוסר יציבות <br>
תמחוי	B: מטבח זול לעניים, מטבח זול לנזקקים <br>
תמימות דעים	B: הסכמה מלאה <br>
תמיר	B: גבוה, זקוף <br>
תמלוג	B: תשלום לבעל זכויות לפי חוק <br>
תמרור	B: צער <br>
תנובה	B: תוצרת חקלאית, יבול <br>
תסכית	B: יצירה כתובה לשידור ברדיו <br>
תסמין	B: סימן היכר <br>
תעה	B: חיפש את הדרך; סטה מדרך הישר <br>
תעודת עניות	B: עדות לחוסר יכולת <br>
תעוקה	B: לחץ, מצוקה <br>
תעצומה	B: עוצמה, כוח <br>
תער	B: סכין גילוח <br>
תעתוע	B: הטעייה, רמאות <br>
תפל	B: חסר טעם <br>
תפס את השור בקרניו	B: ניגש ישר לעניין <br>
תקיעת כף	B: התחייבות, הבטחה <br>
תקע טריז	B: הפריד, סיכסך <br>
תקע יתד	B: התיישב באופן קבוע <br>
תקרובת	B: כיבוד <br>
תר	B: חיפש <br>
תר אחר לבבו	B: הלך אחרי היצר שלו, נגרר אחרי יצריו <br>
תרביך	B: תבשיל בשר וירקות, מאכל העשוי בשר וירקות <br>
תרגימא	B: קינוח, ממתק <br>
תרוג	B: צהוב כאתרוג, צהוב כמו אתרוג <br>
תרווד	B: כף גדולה לבחישה <br>
תרומי	B: מצוין, מובחר <br>
תרחיש	B: תיאור התרחשות אפשרית <br>
תריסר	B: שניים עשר <br>
תרמי	B: הקשור בחום<br>
תרעומת	B: כעס, תלונה<br>
תרפיה	B: ריפוי<br>
תרשיש	B: אבן יקרה; נכבד וחשוב<br>
תרתי דסתריי	B: שני דברים הסותרים זה את זה, דבר והיפוכו<br>
תרתי משמע	B: שני מובנים לאותו דבר<br>
תש	B: נחלש<br>
תש כוחו	B: התעייף, נחלש<br>
תשואה	B: רווח מהשקעה<br>
תשומה	B: כסף ומשאבים המושקעים בדבר<br>
תשורה	B: מתנה<br>
תשחורת	B: נעורים, נוער <br>
תשליל	B: סרט צילום<br>
תשמיש	B: מכשיר, דבר שמשתמשים בו<br>
תשר	B: טיפ, מתנה<br>
תשתית	B: יסוד, בסיס<br>
